time;5.01 BN - Kennedybrücke (Nordseite);5.02 BN - Kennedybrücke (Südseite) Barometer;5.03 BN - Nordbrücke (Südseite);5.04 BN - Nordbrücke (Nordseite);5.05 BN - Südbrücke (Südseite);5.06 BN - Südbrücke (Nordseite);5.07 BN - Estermannufer;5.08 BN - Von-Sandt-Ufer;5.09 BN - Rhenusallee;5.10 BN - Bröhltalweg;5.11 BN - Brühler Straße;5.13 BN - Wilhelm-Spiritus-Ufer;5.14 BN - Mc Cloy Weg;5.15 BN - Weg auf Damm Neil;Kennedybrücke;Nordbrücke;Südbrücke
01.01.2023 00:00;26;25;2;1;12;10;0;3;0;1;3;12;0;8;51;3;22
01.01.2023 01:00;46;88;11;2;15;10;1;5;0;10;13;26;2;12;134;13;25
01.01.2023 02:00;63;80;4;10;11;16;2;3;0;16;3;11;4;13;143;14;27
01.01.2023 03:00;34;66;6;3;16;5;2;3;0;2;6;7;3;10;100;9;21
01.01.2023 04:00;22;32;4;0;5;3;0;4;0;2;1;7;2;12;54;4;8
01.01.2023 05:00;15;26;2;4;3;4;1;2;0;0;7;8;1;2;41;6;7
01.01.2023 06:00;17;8;1;1;2;1;0;4;0;1;5;7;3;5;25;2;3
01.01.2023 07:00;5;17;0;1;0;1;2;3;0;2;1;0;4;0;22;1;1
01.01.2023 08:00;8;16;7;1;7;3;0;1;0;1;8;14;5;4;24;8;10
01.01.2023 09:00;20;19;5;3;11;14;3;30;0;5;12;23;16;9;39;8;25
01.01.2023 10:00;21;45;22;6;23;17;9;50;0;8;9;36;37;22;66;28;40
01.01.2023 11:00;27;49;27;11;21;38;9;46;0;10;13;62;39;69;76;38;59
01.01.2023 12:00;57;71;49;18;56;49;29;60;0;22;22;116;59;90;128;67;105
01.01.2023 13:00;59;121;58;29;64;67;50;72;0;39;33;98;79;125;180;87;131
01.01.2023 14:00;58;107;55;34;67;55;34;91;0;34;22;105;99;95;165;89;122
01.01.2023 15:00;82;140;58;35;76;85;41;109;0;35;28;119;103;114;222;93;161
01.01.2023 16:00;85;128;32;37;64;51;27;73;0;38;26;113;56;116;213;69;115
01.01.2023 17:00;77;84;8;16;28;30;6;27;0;22;25;39;21;45;161;24;58
01.01.2023 18:00;63;46;4;3;9;9;2;8;0;8;12;18;5;14;109;7;18
01.01.2023 19:00;32;54;5;2;12;7;3;4;0;3;9;8;0;3;86;7;19
01.01.2023 20:00;32;47;2;3;8;4;4;0;0;3;4;9;1;10;79;5;12
01.01.2023 21:00;16;34;5;0;9;8;3;4;0;2;7;7;4;7;50;5;17
01.01.2023 22:00;7;21;1;2;7;2;2;5;0;1;7;3;2;5;28;3;9
01.01.2023 23:00;5;11;3;2;1;2;1;3;0;2;4;2;0;4;16;5;3
02.01.2023 00:00;8;6;2;0;0;0;0;0;0;0;1;0;0;3;14;2;0
02.01.2023 01:00;9;7;0;0;2;2;0;1;0;1;0;2;0;4;16;0;4
02.01.2023 02:00;2;4;0;1;1;0;0;1;0;0;2;1;0;1;6;1;1
02.01.2023 03:00;0;4;2;0;3;1;1;0;0;0;2;1;0;0;4;2;4
02.01.2023 04:00;3;7;0;1;6;0;0;0;0;0;2;2;3;0;10;1;6
02.01.2023 05:00;24;20;12;8;17;5;2;2;0;1;11;6;3;4;44;20;22
02.01.2023 06:00;90;80;13;22;42;32;9;11;0;6;35;31;11;23;170;35;74
02.01.2023 07:00;157;147;37;29;73;51;23;42;0;18;46;78;29;48;304;66;124
02.01.2023 08:00;179;152;22;17;96;81;5;50;0;35;46;131;21;79;331;39;177
02.01.2023 09:00;109;108;26;8;51;32;12;37;0;18;29;71;25;39;217;34;83
02.01.2023 10:00;59;81;7;6;26;11;10;25;0;27;23;35;17;21;140;13;37
02.01.2023 11:00;61;96;16;3;18;19;3;7;0;7;15;19;5;23;157;19;37
02.01.2023 12:00;60;110;13;5;26;12;9;17;0;16;25;35;14;31;170;18;38
02.01.2023 13:00;83;125;11;4;21;18;7;18;0;13;33;36;13;30;208;15;39
02.01.2023 14:00;85;149;12;13;22;13;5;13;0;18;36;36;9;33;234;25;35
02.01.2023 15:00;106;166;19;12;47;35;6;21;0;12;31;55;24;34;272;31;82
02.01.2023 16:00;123;245;35;13;71;39;20;32;0;28;60;70;26;53;368;48;110
02.01.2023 17:00;122;249;38;17;76;50;10;43;0;24;38;79;28;52;371;55;126
02.01.2023 18:00;79;184;17;5;47;32;5;21;0;14;47;68;28;32;263;22;79
02.01.2023 19:00;48;150;6;4;20;22;4;10;0;8;26;28;3;22;198;10;42
02.01.2023 20:00;44;84;4;3;17;5;1;5;0;5;17;8;7;10;128;7;22
02.01.2023 21:00;27;63;8;0;6;4;2;1;0;6;15;8;3;10;90;8;10
02.01.2023 22:00;21;38;1;0;3;5;0;5;0;0;9;4;2;4;59;1;8
02.01.2023 23:00;7;19;2;1;3;3;0;0;0;4;3;5;0;2;26;3;6
03.01.2023 00:00;5;12;0;0;3;3;0;0;0;1;2;2;2;1;17;0;6
03.01.2023 01:00;1;5;0;1;0;0;0;0;0;1;0;0;1;0;6;1;0
03.01.2023 02:00;4;2;2;0;1;0;0;2;0;0;0;1;1;2;6;2;1
03.01.2023 03:00;0;5;0;0;2;2;0;0;0;0;2;0;0;1;5;0;4
03.01.2023 04:00;0;7;2;1;3;1;0;0;0;0;2;2;0;0;7;3;4
03.01.2023 05:00;28;29;13;9;22;4;2;2;0;2;16;8;1;10;57;22;26
03.01.2023 06:00;94;88;26;29;46;21;14;10;0;5;35;32;12;24;182;55;67
03.01.2023 07:00;215;155;50;30;111;71;27;57;0;21;72;123;38;57;370;80;182
03.01.2023 08:00;221;201;56;19;152;132;23;81;0;29;78;214;42;113;422;75;284
03.01.2023 09:00;150;174;32;6;77;49;18;60;0;24;42;124;25;77;324;38;126
03.01.2023 10:00;119;169;30;19;44;37;13;72;0;19;32;100;69;85;288;49;81
03.01.2023 11:00;151;213;46;30;50;52;37;91;0;34;55;110;57;120;364;76;102
03.01.2023 12:00;178;287;55;23;76;90;44;105;0;37;59;177;74;155;465;78;166
03.01.2023 13:00;165;289;82;35;92;75;47;97;0;40;81;161;74;168;454;117;167
03.01.2023 14:00;180;305;64;53;127;78;53;126;0;49;61;196;102;184;485;117;205
03.01.2023 15:00;217;418;72;41;163;120;62;121;0;91;67;197;122;199;635;113;283
03.01.2023 16:00;239;436;89;37;173;138;53;129;0;53;90;227;104;211;675;126;311
03.01.2023 17:00;202;411;75;38;106;106;32;77;0;45;79;188;54;131;613;113;212
03.01.2023 18:00;115;347;37;18;95;63;27;61;0;28;60;140;46;84;462;55;158
03.01.2023 19:00;111;211;18;13;47;29;8;30;0;10;34;65;25;51;322;31;76
03.01.2023 20:00;60;122;6;4;18;16;3;27;0;11;21;33;21;26;182;10;34
03.01.2023 21:00;45;114;9;2;10;15;1;10;0;14;25;22;12;14;159;11;25
03.01.2023 22:00;42;71;4;4;13;6;6;6;0;0;18;9;5;12;113;8;19
03.01.2023 23:00;14;44;3;1;4;7;1;4;0;3;8;3;5;2;58;4;11
04.01.2023 00:00;7;10;1;0;1;2;0;4;0;1;5;2;0;2;17;1;3
04.01.2023 01:00;2;6;0;0;1;1;0;0;0;0;1;3;0;2;8;0;2
04.01.2023 02:00;2;2;0;0;3;0;0;1;0;0;1;2;0;0;4;0;3
04.01.2023 03:00;0;6;0;0;3;0;0;1;0;0;1;1;0;0;6;0;3
04.01.2023 04:00;3;10;2;1;4;0;0;2;0;0;1;1;1;0;13;3;4
04.01.2023 05:00;21;30;11;4;16;7;2;2;0;1;9;11;3;1;51;15;23
04.01.2023 06:00;80;74;14;15;39;19;9;13;0;8;22;21;10;22;154;29;58
04.01.2023 07:00;170;152;43;30;90;54;19;44;0;11;57;97;29;45;322;73;144
04.01.2023 08:00;223;208;35;19;134;118;18;77;0;32;55;185;32;95;431;54;252
04.01.2023 09:00;136;175;23;10;56;59;7;53;0;14;48;112;24;51;311;33;115
04.01.2023 10:00;110;172;14;8;45;19;8;34;0;7;37;64;22;49;282;22;64
04.01.2023 11:00;106;172;21;10;30;26;6;50;0;30;24;60;27;47;278;31;56
04.01.2023 12:00;80;199;23;11;33;28;12;37;0;28;38;66;27;57;279;34;61
04.01.2023 13:00;97;183;19;12;42;30;11;20;0;21;43;54;19;44;280;31;72
04.01.2023 14:00;111;180;17;21;42;41;6;41;0;18;44;73;19;50;291;38;83
04.01.2023 15:00;114;229;32;11;62;39;14;54;0;26;36;90;29;49;343;43;101
04.01.2023 16:00;143;322;52;17;87;72;26;50;0;25;61;144;55;80;465;69;159
04.01.2023 17:00;156;323;40;19;122;71;14;74;0;37;62;142;33;98;479;59;193
04.01.2023 18:00;142;271;21;11;78;59;6;37;0;23;39;114;25;72;413;32;137
04.01.2023 19:00;89;187;12;9;35;36;4;19;0;18;29;48;8;38;276;21;71
04.01.2023 20:00;71;137;11;6;25;7;2;18;0;12;16;26;13;23;208;17;32
04.01.2023 21:00;56;106;12;0;22;4;0;9;0;6;12;15;9;14;162;12;26
04.01.2023 22:00;44;90;1;6;14;7;1;5;0;6;16;15;3;13;134;7;21
04.01.2023 23:00;23;34;3;2;3;4;2;2;0;1;6;4;1;7;57;5;7
05.01.2023 00:00;6;12;2;0;4;1;0;1;0;0;5;0;6;2;18;2;5
05.01.2023 01:00;5;9;2;0;2;1;0;0;0;0;0;2;1;2;14;2;3
05.01.2023 02:00;2;4;2;0;0;0;0;0;0;0;3;0;3;0;6;2;0
05.01.2023 03:00;4;8;1;0;2;1;0;1;0;1;1;0;2;0;12;1;3
05.01.2023 04:00;1;6;2;2;4;1;0;2;0;1;4;0;0;0;7;4;5
05.01.2023 05:00;29;25;14;5;18;7;2;2;0;1;16;7;1;3;54;19;25
05.01.2023 06:00;88;98;21;21;43;22;12;19;0;1;29;28;11;29;186;42;65
05.01.2023 07:00;193;172;40;29;117;79;25;54;0;21;62;106;45;63;365;69;196
05.01.2023 08:00;245;225;34;18;143;128;17;90;0;38;76;210;41;100;470;52;271
05.01.2023 09:00;137;197;26;12;75;61;10;55;0;18;46;120;24;61;334;38;136
05.01.2023 10:00;125;151;16;19;30;33;7;36;0;15;39;59;34;58;276;35;63
05.01.2023 11:00;139;186;19;18;29;33;21;51;0;12;30;59;31;77;325;37;62
05.01.2023 12:00;152;195;28;12;49;33;29;59;0;28;46;95;40;75;347;40;82
05.01.2023 13:00;136;251;38;16;45;51;30;74;0;26;58;97;51;76;387;54;96
05.01.2023 14:00;159;246;44;37;73;67;25;73;0;32;62;148;65;116;405;81;140
05.01.2023 15:00;171;365;63;22;88;85;45;90;0;41;78;156;74;134;536;85;173
05.01.2023 16:00;211;375;80;28;144;122;28;112;0;54;74;185;82;155;586;108;266
05.01.2023 17:00;223;434;47;24;139;82;14;85;0;34;77;163;52;115;657;71;221
05.01.2023 18:00;154;301;44;14;78;65;20;37;0;23;55;124;36;64;455;58;143
05.01.2023 19:00;100;245;21;5;27;32;6;19;0;14;32;53;7;52;345;26;59
05.01.2023 20:00;76;123;14;2;25;14;3;8;0;11;14;28;8;18;199;16;39
05.01.2023 21:00;45;114;9;3;16;6;0;10;0;3;10;17;9;6;159;12;22
05.01.2023 22:00;62;82;5;2;6;2;0;3;0;3;13;15;0;13;144;7;8
05.01.2023 23:00;12;46;7;3;2;4;2;3;0;1;3;7;1;6;58;10;6
06.01.2023 00:00;11;17;0;0;3;4;0;0;0;0;3;2;0;3;28;0;7
06.01.2023 01:00;2;20;0;0;1;1;1;0;0;0;1;2;2;0;22;0;2
06.01.2023 02:00;4;6;1;0;3;1;0;0;0;1;0;0;0;0;10;1;4
06.01.2023 03:00;4;7;0;0;2;1;0;0;0;0;1;0;1;1;11;0;3
06.01.2023 04:00;1;6;1;3;3;0;0;0;0;1;1;2;2;0;7;4;3
06.01.2023 05:00;25;27;6;4;13;6;1;3;0;3;6;6;4;5;52;10;19
06.01.2023 06:00;68;86;22;23;44;16;11;11;0;3;24;26;11;16;154;45;60
06.01.2023 07:00;156;157;44;22;66;55;16;45;0;15;52;90;30;49;313;66;121
06.01.2023 08:00;184;200;27;14;110;91;7;78;0;33;54;141;38;79;384;41;201
06.01.2023 09:00;121;174;23;10;69;64;13;69;0;20;48;102;24;64;295;33;133
06.01.2023 10:00;119;183;21;12;38;26;17;38;0;10;35;77;35;62;302;33;64
06.01.2023 11:00;113;215;21;16;44;33;19;48;0;35;26;92;35;58;328;37;77
06.01.2023 12:00;153;258;36;10;37;34;26;64;0;30;37;103;46;69;411;46;71
06.01.2023 13:00;138;257;28;18;73;51;14;58;0;24;52;91;52;73;395;46;124
06.01.2023 14:00;133;291;45;28;76;63;19;87;0;29;57;113;53;71;424;73;139
06.01.2023 15:00;171;319;41;17;107;89;23;81;0;44;65;149;47;119;490;58;196
06.01.2023 16:00;170;297;48;30;100;77;26;89;0;34;53;148;60;113;467;78;177
06.01.2023 17:00;167;371;52;19;85;48;9;56;0;37;73;113;42;104;538;71;133
06.01.2023 18:00;153;290;28;7;57;50;9;36;0;20;49;84;18;62;443;35;107
06.01.2023 19:00;118;221;8;3;35;25;4;18;0;24;50;40;11;45;339;11;60
06.01.2023 20:00;89;115;18;6;23;13;1;16;0;6;15;24;6;9;204;24;36
06.01.2023 21:00;66;114;6;3;17;7;0;10;0;9;9;11;5;16;180;9;24
06.01.2023 22:00;49;87;1;3;17;8;0;8;0;3;15;15;3;15;136;4;25
06.01.2023 23:00;50;71;6;1;14;5;0;1;0;5;7;16;5;8;121;7;19
07.01.2023 00:00;21;42;3;4;9;7;0;5;0;2;12;3;0;6;63;7;16
07.01.2023 01:00;18;27;1;0;4;10;1;1;0;0;11;6;1;6;45;1;14
07.01.2023 02:00;10;21;2;0;2;0;0;0;0;4;2;0;0;2;31;2;2
07.01.2023 03:00;5;15;1;0;2;1;1;3;0;1;1;0;0;2;20;1;3
07.01.2023 04:00;3;6;4;0;0;1;1;2;0;0;2;3;1;0;9;4;1
07.01.2023 05:00;7;18;3;1;7;4;1;1;0;0;3;5;1;2;25;4;11
07.01.2023 06:00;13;16;2;0;7;1;1;1;0;1;2;8;0;3;29;2;8
07.01.2023 07:00;9;23;1;3;7;2;2;2;0;1;3;2;5;1;32;4;9
07.01.2023 08:00;25;55;26;2;17;11;8;26;0;5;16;25;13;21;80;28;28
07.01.2023 09:00;89;98;16;12;41;22;4;37;0;17;30;31;30;72;187;28;63
07.01.2023 10:00;122;183;34;26;58;39;16;51;0;22;39;85;49;86;305;60;97
07.01.2023 11:00;156;270;66;30;70;66;25;81;0;45;52;137;51;150;426;96;136
07.01.2023 12:00;170;328;69;45;77;61;48;105;0;48;56;157;76;172;498;114;138
07.01.2023 13:00;202;305;49;31;100;64;62;130;0;44;37;173;115;159;507;80;164
07.01.2023 14:00;155;322;81;47;114;98;57;132;0;45;58;208;101;190;477;128;212
07.01.2023 15:00;157;292;68;54;83;82;63;144;0;55;67;245;107;195;449;122;165
07.01.2023 16:00;162;251;60;32;94;84;53;114;0;34;40;175;91;172;413;92;178
07.01.2023 17:00;122;246;21;11;47;58;11;64;0;33;32;84;47;81;368;32;105
07.01.2023 18:00;96;191;14;6;34;14;7;36;0;9;27;38;22;43;287;20;48
07.01.2023 19:00;83;179;15;1;13;11;5;10;0;3;16;23;6;23;262;16;24
07.01.2023 20:00;72;119;6;3;16;7;2;7;0;5;12;15;9;20;191;9;23
07.01.2023 21:00;63;65;3;5;7;7;3;7;0;5;8;11;2;5;128;8;14
07.01.2023 22:00;38;80;6;1;8;5;0;4;0;6;11;21;0;11;118;7;13
07.01.2023 23:00;40;54;1;4;9;8;1;4;0;0;13;1;1;5;94;5;17
08.01.2023 00:00;19;70;3;1;4;5;0;2;0;4;8;4;2;6;89;4;9
08.01.2023 01:00;26;58;6;0;8;3;0;1;0;0;1;0;2;5;84;6;11
08.01.2023 02:00;10;21;1;0;3;5;2;0;0;0;3;6;1;5;31;1;8
08.01.2023 03:00;3;22;2;0;5;1;0;0;0;0;4;3;0;4;25;2;6
08.01.2023 04:00;6;12;0;0;2;0;0;0;0;0;2;1;0;2;18;0;2
08.01.2023 05:00;3;8;0;0;3;2;2;2;0;0;1;2;1;2;11;0;5
08.01.2023 06:00;5;11;3;1;4;1;0;1;0;1;4;3;1;3;16;4;5
08.01.2023 07:00;10;22;6;4;6;1;6;6;0;0;4;13;4;2;32;10;7
08.01.2023 08:00;20;38;11;2;9;13;2;13;0;3;10;12;14;12;58;13;22
08.01.2023 09:00;35;107;16;10;34;12;4;21;0;6;28;27;22;35;142;26;46
08.01.2023 10:00;61;110;28;13;42;37;8;75;0;19;16;56;35;63;171;41;79
08.01.2023 11:00;77;145;49;18;55;62;27;91;0;28;26;119;89;102;222;67;117
08.01.2023 12:00;106;173;62;25;69;82;43;95;0;36;25;128;72;127;279;87;151
08.01.2023 13:00;164;227;77;47;95;90;92;137;0;53;21;181;109;201;391;124;185
08.01.2023 14:00;163;289;82;44;112;107;62;144;0;54;34;212;99;222;452;126;219
08.01.2023 15:00;166;253;71;57;125;111;58;131;0;64;33;194;90;180;419;128;236
08.01.2023 16:00;128;202;68;37;94;97;47;103;0;46;25;182;73;154;330;105;191
08.01.2023 17:00;143;185;37;16;49;33;19;70;0;23;33;78;34;68;328;53;82
08.01.2023 18:00;128;155;20;5;37;26;9;20;0;8;30;41;13;40;283;25;63
08.01.2023 19:00;79;145;6;2;13;5;2;7;0;8;27;16;12;23;224;8;18
08.01.2023 20:00;73;58;6;2;16;10;11;7;0;6;6;11;4;14;131;8;26
08.01.2023 21:00;53;52;6;1;5;3;1;5;0;2;14;16;2;8;105;7;8
08.01.2023 22:00;25;40;4;1;8;2;2;0;0;2;6;5;0;5;65;5;10
08.01.2023 23:00;12;16;0;0;4;3;0;1;0;0;2;1;0;1;28;0;7
09.01.2023 00:00;2;5;1;0;2;0;0;0;0;0;1;0;0;2;7;1;2
09.01.2023 01:00;1;4;0;0;3;1;0;0;0;1;0;1;0;2;5;0;4
09.01.2023 02:00;2;2;0;0;0;1;0;0;0;0;1;2;0;0;4;0;1
09.01.2023 03:00;1;3;0;0;4;1;0;0;0;1;1;0;0;1;4;0;5
09.01.2023 04:00;4;5;1;0;1;0;0;0;0;1;4;0;2;1;9;1;1
09.01.2023 05:00;39;42;15;6;17;8;4;6;0;3;18;15;6;8;81;21;25
09.01.2023 06:00;110;122;29;30;64;33;16;18;0;8;44;42;13;37;232;59;97
09.01.2023 07:00;398;357;74;59;167;139;42;110;0;44;115;208;63;173;755;133;306
09.01.2023 08:00;379;329;51;27;203;172;29;119;0;47;107;296;61;145;708;78;375
09.01.2023 09:00;190;221;24;14;76;65;6;66;0;33;62;124;29;82;411;38;141
09.01.2023 10:00;144;177;18;14;39;30;8;42;0;16;28;52;21;56;321;32;69
09.01.2023 11:00;105;194;14;15;36;35;6;51;0;24;50;73;34;70;299;29;71
09.01.2023 12:00;112;242;28;9;56;29;20;47;0;25;68;86;23;72;354;37;85
09.01.2023 13:00;144;286;30;16;71;51;20;62;0;22;61;89;37;74;430;46;122
09.01.2023 14:00;150;307;35;23;61;52;16;42;0;24;64;108;24;68;457;58;113
09.01.2023 15:00;191;356;48;22;111;65;21;68;0;53;86;123;35;93;547;70;176
09.01.2023 16:00;220;519;76;40;140;118;30;97;0;43;105;165;50;146;739;116;258
09.01.2023 17:00;212;490;79;37;143;105;14;92;0;54;102;219;45;116;702;116;248
09.01.2023 18:00;189;414;35;13;110;80;14;56;0;35;66;148;31;122;603;48;190
09.01.2023 19:00;159;268;22;12;45;40;5;26;0;21;40;70;17;69;427;34;85
09.01.2023 20:00;92;165;16;6;30;15;9;13;0;16;21;34;11;33;257;22;45
09.01.2023 21:00;51;117;10;1;19;6;1;7;0;5;19;16;6;17;168;11;25
09.01.2023 22:00;60;110;7;2;12;7;3;4;0;8;13;10;3;3;170;9;19
09.01.2023 23:00;8;32;4;0;3;0;0;1;0;1;3;2;1;3;40;4;3
10.01.2023 00:00;6;13;0;1;1;0;0;0;0;0;2;2;0;0;19;1;1
10.01.2023 01:00;2;5;0;0;1;2;0;0;0;0;1;0;0;0;7;0;3
10.01.2023 02:00;6;2;0;0;1;1;0;0;0;2;1;0;0;1;8;0;2
10.01.2023 03:00;0;8;0;1;3;1;0;0;0;1;4;0;0;1;8;1;4
10.01.2023 04:00;4;8;1;1;4;0;0;1;0;0;4;1;3;1;12;2;4
10.01.2023 05:00;34;42;18;7;24;8;2;6;0;2;12;14;6;8;76;25;32
10.01.2023 06:00;112;125;31;43;63;47;20;21;0;11;53;52;17;34;237;74;110
10.01.2023 07:00;395;365;86;64;184;150;35;106;0;57;111;216;64;188;760;150;334
10.01.2023 08:00;386;400;64;27;240;214;37;174;0;40;105;394;68;168;786;91;454
10.01.2023 09:00;225;213;49;29;93;80;15;69;0;30;60;147;23;84;438;78;173
10.01.2023 10:00;136;192;29;16;44;37;40;61;0;20;61;75;30;58;328;45;81
10.01.2023 11:00;119;214;28;29;58;40;30;54;0;25;41;101;48;94;333;57;98
10.01.2023 12:00;166;280;47;17;58;55;31;65;0;42;65;137;44;101;446;64;113
10.01.2023 13:00;181;379;49;31;88;80;34;61;0;34;62;110;35;107;560;80;168
10.01.2023 14:00;156;317;50;25;83;73;16;73;0;44;76;132;42;115;473;75;156
10.01.2023 15:00;207;419;62;32;138;78;31;96;0;41;82;162;65;144;626;94;216
10.01.2023 16:00;219;521;90;32;178;126;42;112;0;58;107;192;53;137;740;122;304
10.01.2023 17:00;193;456;61;32;135;91;18;56;0;41;78;200;35;98;649;93;226
10.01.2023 18:00;155;342;42;20;116;70;12;33;0;28;47;109;24;68;497;62;186
10.01.2023 19:00;106;215;13;7;46;36;6;28;0;10;45;60;7;29;321;20;82
10.01.2023 20:00;77;172;12;5;27;19;5;10;0;15;20;21;12;23;249;17;46
10.01.2023 21:00;33;109;8;3;18;14;1;5;0;7;20;19;7;16;142;11;32
10.01.2023 22:00;41;75;2;2;8;9;0;3;0;1;13;7;2;7;116;4;17
10.01.2023 23:00;23;39;3;7;5;1;1;5;0;4;8;8;0;3;62;10;6
11.01.2023 00:00;9;7;0;0;1;1;0;0;0;1;12;2;0;1;16;0;2
11.01.2023 01:00;2;4;0;0;3;0;0;0;0;1;1;0;0;0;6;0;3
11.01.2023 02:00;3;7;0;0;2;0;0;0;0;0;0;0;0;0;10;0;2
11.01.2023 03:00;0;5;1;0;6;0;0;0;0;0;2;0;0;1;5;1;6
11.01.2023 04:00;4;13;1;1;5;0;0;0;0;0;5;3;1;2;17;2;5
11.01.2023 05:00;27;27;12;1;23;4;1;6;0;2;11;12;4;3;54;13;27
11.01.2023 06:00;66;73;16;20;44;23;21;14;0;7;29;30;13;17;139;36;67
11.01.2023 07:00;269;239;68;43;108;86;29;57;0;19;74;132;30;114;508;111;194
11.01.2023 08:00;271;234;38;21;164;125;15;69;0;37;72;210;32;103;505;59;289
11.01.2023 09:00;117;146;18;15;36;35;9;36;0;11;24;93;7;40;263;33;71
11.01.2023 10:00;58;105;7;2;20;18;1;13;0;12;26;25;3;15;163;9;38
11.01.2023 11:00;71;115;9;4;16;20;4;18;0;7;19;35;14;24;186;13;36
11.01.2023 12:00;107;169;8;9;38;28;8;30;0;20;43;55;16;39;276;17;66
11.01.2023 13:00;129;233;20;15;66;52;22;48;0;28;37;89;35;68;362;35;118
11.01.2023 14:00;123;243;29;20;69;56;14;66;0;46;50;87;44;75;366;49;125
11.01.2023 15:00;171;327;57;25;96;69;26;60;0;31;79;124;58;127;498;82;165
11.01.2023 16:00;178;424;67;35;131;83;42;99;0;44;94;171;73;159;602;102;214
11.01.2023 17:00;199;460;58;35;130;110;22;66;0;49;89;197;58;151;659;93;240
11.01.2023 18:00;196;359;46;16;95;82;12;33;0;31;50;145;34;84;555;62;177
11.01.2023 19:00;165;293;21;13;56;31;9;24;0;24;40;65;9;63;458;34;87
11.01.2023 20:00;80;163;8;11;38;30;0;12;0;8;28;38;9;33;243;19;68
11.01.2023 21:00;84;127;14;4;30;14;3;9;0;7;17;27;13;22;211;18;44
11.01.2023 22:00;77;134;5;4;13;11;0;6;0;3;24;20;4;15;211;9;24
11.01.2023 23:00;32;43;2;0;7;5;1;3;0;3;5;1;0;4;75;2;12
12.01.2023 00:00;14;16;3;0;3;0;0;0;0;0;5;1;4;2;30;3;3
12.01.2023 01:00;1;5;0;0;2;0;1;0;0;1;4;0;0;0;6;0;2
12.01.2023 02:00;1;9;1;2;2;0;0;0;0;0;0;2;2;0;10;3;2
12.01.2023 03:00;2;2;0;0;2;1;0;2;0;0;2;1;0;1;4;0;3
12.01.2023 04:00;6;9;2;2;2;2;0;0;0;0;5;3;2;2;15;4;4
12.01.2023 05:00;26;29;11;4;18;7;1;2;0;3;12;6;1;7;55;15;25
12.01.2023 06:00;83;97;20;22;43;30;21;16;0;3;33;20;11;21;180;42;73
12.01.2023 07:00;215;229;51;30;108;85;25;55;0;23;68;108;39;105;444;81;193
12.01.2023 08:00;258;244;25;16;143;101;17;69;0;17;50;204;39;80;502;41;244
12.01.2023 09:00;110;149;17;8;52;36;4;37;0;11;37;68;12;34;259;25;88
12.01.2023 10:00;76;97;5;3;16;14;5;8;0;7;22;35;7;19;173;8;30
12.01.2023 11:00;71;95;6;3;21;14;1;16;0;8;14;18;12;16;166;9;35
12.01.2023 12:00;86;149;12;8;32;16;7;19;0;15;23;45;10;28;235;20;48
12.01.2023 13:00;75;180;17;4;47;28;6;22;0;11;35;45;19;33;255;21;75
12.01.2023 14:00;89;205;18;9;41;24;6;36;0;21;42;46;12;43;294;27;65
12.01.2023 15:00;122;249;32;16;65;50;16;45;0;26;56;74;27;68;371;48;115
12.01.2023 16:00;167;348;42;28;97;66;22;61;0;31;63;121;36;91;515;70;163
12.01.2023 17:00;203;348;54;20;96;83;13;65;0;38;67;152;49;68;551;74;179
12.01.2023 18:00;161;317;41;12;87;55;25;34;0;20;63;108;26;77;478;53;142
12.01.2023 19:00;122;214;14;5;31;24;1;25;0;21;30;57;15;40;336;19;55
12.01.2023 20:00;114;140;15;7;26;9;0;7;0;15;22;27;8;37;254;22;35
12.01.2023 21:00;46;129;7;5;23;11;1;7;0;5;5;21;4;12;175;12;34
12.01.2023 22:00;69;101;1;2;16;3;3;6;0;3;11;21;2;13;170;3;19
12.01.2023 23:00;8;54;0;2;3;5;0;0;0;1;7;5;0;3;62;2;8
13.01.2023 00:00;12;22;1;0;1;3;1;1;0;2;6;1;1;2;34;1;4
13.01.2023 01:00;3;14;1;1;3;1;0;0;0;1;0;4;0;0;17;2;4
13.01.2023 02:00;3;5;0;0;2;1;0;0;0;0;0;2;0;1;8;0;3
13.01.2023 03:00;1;3;1;0;3;0;0;0;0;0;3;1;0;0;4;1;3
13.01.2023 04:00;3;8;1;0;2;0;0;1;0;0;2;2;1;3;11;1;2
13.01.2023 05:00;26;29;12;8;15;8;1;2;0;3;15;5;1;6;55;20;23
13.01.2023 06:00;87;91;23;18;42;30;17;17;0;5;49;32;18;28;178;41;72
13.01.2023 07:00;298;279;74;55;128;77;31;82;0;37;77;132;48;136;577;129;205
13.01.2023 08:00;269;282;44;26;139;127;14;91;0;29;72;221;37;102;551;70;266
13.01.2023 09:00;178;229;39;23;62;48;5;35;0;20;26;101;24;76;407;62;110
13.01.2023 10:00;152;195;24;18;35;51;11;44;0;19;48;78;29;64;347;42;86
13.01.2023 11:00;120;257;40;14;43;37;13;51;0;32;58;93;43;83;377;54;80
13.01.2023 12:00;146;287;36;15;64;45;17;55;0;26;70;105;39;88;433;51;109
13.01.2023 13:00;167;375;43;30;67;48;14;63;0;28;95;119;49;95;542;73;115
13.01.2023 14:00;180;340;38;22;92;82;21;58;0;36;85;107;39;84;520;60;174
13.01.2023 15:00;122;342;48;28;96;64;16;82;0;29;68;105;49;80;464;76;160
13.01.2023 16:00;138;343;47;33;104;79;23;62;0;28;64;133;41;104;481;80;183
13.01.2023 17:00;180;342;38;19;93;78;8;54;0;27;48;125;44;79;522;57;171
13.01.2023 18:00;149;285;24;18;56;41;8;29;0;18;35;68;20;59;434;42;97
13.01.2023 19:00;115;238;17;9;38;13;3;31;0;8;32;64;11;31;353;26;51
13.01.2023 20:00;87;159;8;3;20;12;0;15;0;17;24;21;8;22;246;11;32
13.01.2023 21:00;66;105;5;1;20;8;0;12;0;2;25;13;5;13;171;6;28
13.01.2023 22:00;45;109;4;2;8;3;0;4;0;8;4;17;6;15;154;6;11
13.01.2023 23:00;50;83;4;1;12;12;0;5;0;5;14;11;6;9;133;5;24
14.01.2023 00:00;14;91;2;2;4;4;0;3;0;4;7;8;1;10;105;4;8
14.01.2023 01:00;16;39;5;0;6;3;0;2;0;5;4;6;1;5;55;5;9
14.01.2023 02:00;8;23;0;0;3;1;0;1;0;1;2;0;0;3;31;0;4
14.01.2023 03:00;6;12;2;0;2;2;0;0;0;0;1;0;1;0;18;2;4
14.01.2023 04:00;6;8;2;0;0;1;0;1;0;1;1;2;1;1;14;2;1
14.01.2023 05:00;7;14;4;1;1;3;2;2;0;0;7;4;2;1;21;5;4
14.01.2023 06:00;11;20;5;3;5;5;1;1;0;0;12;3;0;3;31;8;10
14.01.2023 07:00;13;31;5;4;9;3;0;4;0;2;9;8;3;8;44;9;12
14.01.2023 08:00;31;127;9;2;25;14;4;17;0;7;12;28;13;16;158;11;39
14.01.2023 09:00;98;178;16;10;23;19;5;20;0;18;27;42;7;53;276;26;42
14.01.2023 10:00;94;183;27;9;23;21;9;32;0;23;26;50;20;52;277;36;44
14.01.2023 11:00;110;184;26;14;38;27;11;29;0;29;33;55;29;75;294;40;65
14.01.2023 12:00;94;211;22;14;30;24;12;29;0;28;28;59;21;67;305;36;54
14.01.2023 13:00;76;184;23;6;27;22;3;30;0;18;30;55;28;33;260;29;49
14.01.2023 14:00;85;170;18;8;23;31;4;34;0;9;47;59;8;53;255;26;54
14.01.2023 15:00;63;138;15;9;25;12;10;32;0;11;31;28;27;28;201;24;37
14.01.2023 16:00;67;163;14;8;21;15;5;27;0;13;19;46;23;32;230;22;36
14.01.2023 17:00;72;145;6;6;17;14;5;22;0;9;31;36;16;22;217;12;31
14.01.2023 18:00;78;160;5;5;17;7;3;9;0;12;19;30;8;14;238;10;24
14.01.2023 19:00;128;118;6;3;10;7;1;10;0;11;10;20;3;21;246;9;17
14.01.2023 20:00;100;104;3;1;13;4;1;4;0;3;10;14;2;4;204;4;17
14.01.2023 21:00;54;55;6;2;9;5;0;2;0;5;7;8;6;7;109;8;14
14.01.2023 22:00;33;41;0;3;3;4;0;2;0;2;3;5;0;2;74;3;7
14.01.2023 23:00;29;56;0;0;4;3;0;3;0;2;6;7;3;4;85;0;7
15.01.2023 00:00;21;44;1;0;3;0;0;0;0;0;1;1;0;1;65;1;3
15.01.2023 01:00;7;15;2;1;5;2;0;1;0;2;3;0;1;1;22;3;7
15.01.2023 02:00;7;19;0;0;1;2;0;0;0;2;1;3;0;2;26;0;3
15.01.2023 03:00;5;11;1;3;0;2;0;0;0;0;1;4;1;4;16;4;2
15.01.2023 04:00;4;11;2;0;1;1;0;0;0;0;1;0;1;1;15;2;2
15.01.2023 05:00;6;8;3;0;2;2;1;0;0;0;3;1;2;1;14;3;4
15.01.2023 06:00;8;13;2;2;1;2;2;2;0;3;1;1;0;2;21;4;3
15.01.2023 07:00;14;13;3;0;7;4;0;3;0;3;3;4;3;2;27;3;11
15.01.2023 08:00;16;34;7;1;13;8;2;8;0;3;7;9;7;12;50;8;21
15.01.2023 09:00;44;65;12;7;18;12;2;22;0;14;9;30;21;36;109;19;30
15.01.2023 10:00;61;90;31;11;46;33;13;67;0;12;15;73;29;62;151;42;79
15.01.2023 11:00;75;127;53;18;59;55;13;82;0;22;37;98;59;99;202;71;114
15.01.2023 12:00;129;202;74;33;81;105;34;124;0;53;19;146;99;183;331;107;186
15.01.2023 13:00;128;211;62;46;94;100;40;131;0;37;25;151;115;172;339;108;194
15.01.2023 14:00;120;202;63;30;92;87;42;141;0;56;30;155;115;127;322;93;179
15.01.2023 15:00;151;171;44;34;97;65;25;141;0;37;36;141;96;130;322;78;162
15.01.2023 16:00;110;169;44;37;45;51;17;71;0;46;25;93;65;108;279;81;96
15.01.2023 17:00;133;184;20;15;42;36;8;47;0;22;24;75;32;66;317;35;78
15.01.2023 18:00;91;129;11;7;33;21;2;9;0;18;15;29;13;37;220;18;54
15.01.2023 19:00;46;92;6;4;14;12;0;4;0;6;21;22;4;14;138;10;26
15.01.2023 20:00;58;69;2;4;6;9;3;15;0;3;8;21;4;18;127;6;15
15.01.2023 21:00;41;76;7;1;8;3;0;5;0;1;13;12;2;6;117;8;11
15.01.2023 22:00;33;45;4;2;9;3;2;1;0;5;8;6;0;6;78;6;12
15.01.2023 23:00;13;25;0;0;2;2;0;0;0;1;4;1;0;2;38;0;4
16.01.2023 00:00;2;21;0;0;3;0;0;0;0;0;5;0;0;3;23;0;3
16.01.2023 01:00;3;4;0;0;1;1;0;0;0;0;7;1;0;0;7;0;2
16.01.2023 02:00;1;3;1;0;4;0;0;0;0;0;1;0;0;1;4;1;4
16.01.2023 03:00;1;4;1;0;3;1;0;0;0;0;2;0;1;0;5;1;4
16.01.2023 04:00;4;6;2;0;1;1;0;0;0;0;5;2;0;0;10;2;2
16.01.2023 05:00;34;33;10;8;18;8;0;4;0;2;14;6;5;7;67;18;26
16.01.2023 06:00;104;88;24;41;52;37;3;16;0;5;39;38;11;25;192;65;89
16.01.2023 07:00;281;275;71;54;133;100;15;75;0;29;82;171;45;122;556;125;233
16.01.2023 08:00;322;325;55;29;150;133;5;105;0;41;81;251;39;87;647;84;283
16.01.2023 09:00;156;165;23;11;47;40;0;37;0;13;28;84;8;43;321;34;87
16.01.2023 10:00;87;125;11;7;13;19;1;10;0;16;24;19;4;22;212;18;32
16.01.2023 11:00;85;142;12;7;14;25;6;24;0;14;35;42;4;35;227;19;39
16.01.2023 12:00;91;172;15;11;25;24;2;30;0;18;54;58;1;27;263;26;49
16.01.2023 13:00;107;193;31;13;45;40;2;18;0;23;47;51;5;48;300;44;85
16.01.2023 14:00;113;217;20;12;43;28;1;20;0;20;46;39;2;50;330;32;71
16.01.2023 15:00;137;275;42;8;69;45;0;49;0;36;74;87;4;55;412;50;114
16.01.2023 16:00;182;374;77;36;97;68;2;63;0;30;81;134;2;93;556;113;165
16.01.2023 17:00;190;473;50;31;117;78;7;57;0;31;80;152;2;87;663;81;195
16.01.2023 18:00;128;358;27;17;84;65;0;40;0;22;61;142;0;71;486;44;149
16.01.2023 19:00;151;217;13;10;40;24;3;18;0;14;32;62;0;57;368;23;64
16.01.2023 20:00;75;146;10;3;20;12;0;6;0;15;15;27;0;15;221;13;32
16.01.2023 21:00;53;97;7;2;16;4;0;3;0;7;18;11;0;10;150;9;20
16.01.2023 22:00;40;80;7;2;11;7;0;2;0;2;16;6;0;1;120;9;18
16.01.2023 23:00;18;24;1;3;2;5;0;0;0;1;6;4;0;2;42;4;7
17.01.2023 00:00;2;10;0;1;1;0;0;1;0;0;2;1;0;0;12;1;1
17.01.2023 01:00;1;6;1;0;0;0;0;1;0;0;0;0;0;0;7;1;0
17.01.2023 02:00;3;7;1;0;1;0;0;0;0;0;0;1;0;1;10;1;1
17.01.2023 03:00;1;3;0;0;2;0;0;1;0;0;2;0;0;1;4;0;2
17.01.2023 04:00;4;8;1;0;4;1;0;0;0;0;5;2;0;0;12;1;5
17.01.2023 05:00;44;26;10;7;22;10;0;5;0;3;13;12;0;6;70;17;32
17.01.2023 06:00;111;111;35;37;55;40;3;13;0;4;50;34;0;22;222;72;95
17.01.2023 07:00;355;332;71;65;148;123;6;80;0;44;102;172;0;141;687;136;271
17.01.2023 08:00;375;378;75;28;238;198;6;138;0;46;108;349;0;188;753;103;436
17.01.2023 09:00;220;242;31;19;95;76;7;62;0;26;63;153;0;84;462;50;171
17.01.2023 10:00;139;171;20;18;40;35;1;29;0;16;42;58;0;70;310;38;75
17.01.2023 11:00;123;194;18;10;46;48;5;43;0;25;45;74;0;68;317;28;94
17.01.2023 12:00;142;272;49;20;68;47;8;56;0;36;49;86;0;97;414;69;115
17.01.2023 13:00;164;317;56;22;85;65;21;82;0;40;62;106;0;121;481;78;150
17.01.2023 14:00;168;307;45;38;87;62;1;76;0;49;63;135;0;122;475;83;149
17.01.2023 15:00;207;368;62;27;109;79;5;81;0;54;81;173;0;147;575;89;188
17.01.2023 16:00;206;524;84;51;161;124;1;104;0;50;137;210;0;158;730;135;285
17.01.2023 17:00;219;503;90;37;174;106;5;73;0;58;89;242;0;159;722;127;280
17.01.2023 18:00;214;477;52;20;123;98;0;49;0;40;69;178;0;119;691;72;221
17.01.2023 19:00;154;306;21;9;51;37;0;32;0;17;51;69;0;56;460;30;88
17.01.2023 20:00;87;177;11;12;23;17;0;7;0;10;28;38;0;39;264;23;40
17.01.2023 21:00;85;155;14;2;22;18;0;3;0;11;31;10;0;24;240;16;40
17.01.2023 22:00;51;103;8;3;11;8;0;8;0;2;13;12;0;12;154;11;19
17.01.2023 23:00;26;59;2;1;9;6;0;1;0;3;12;5;0;4;85;3;15
18.01.2023 00:00;0;22;0;2;3;1;0;0;0;0;10;1;0;1;22;2;4
18.01.2023 01:00;2;7;0;0;1;0;0;0;0;0;1;1;0;0;9;0;1
18.01.2023 02:00;1;4;0;0;1;0;0;0;0;0;0;0;0;0;5;0;1
18.01.2023 03:00;0;3;1;0;2;0;0;0;0;0;5;0;0;0;3;1;2
18.01.2023 04:00;7;8;3;1;4;1;0;0;0;0;8;3;0;2;15;4;5
18.01.2023 05:00;28;37;9;7;18;10;0;3;0;1;16;8;0;5;65;16;28
18.01.2023 06:00;92;118;29;29;51;36;0;14;0;8;53;40;0;33;210;58;87
18.01.2023 07:00;311;294;80;55;150;119;0;78;0;30;87;169;0;135;605;135;269
18.01.2023 08:00;388;359;58;23;219;175;1;106;0;43;97;306;0;161;747;81;394
18.01.2023 09:00;158;203;29;18;73;73;2;58;0;22;49;133;0;61;361;47;146
18.01.2023 10:00;129;168;23;10;42;21;2;33;0;15;32;63;0;46;297;33;63
18.01.2023 11:00;112;143;22;12;34;39;0;32;0;15;36;63;0;47;255;34;73
18.01.2023 12:00;130;259;29;22;50;36;0;40;0;29;46;62;0;63;389;51;86
18.01.2023 13:00;146;276;40;11;67;47;2;48;0;33;56;93;0;83;422;51;114
18.01.2023 14:00;141;326;39;14;85;71;8;56;0;34;68;127;1;106;467;53;156
18.01.2023 15:00;178;363;54;26;120;104;11;82;0;57;71;150;0;143;541;80;224
18.01.2023 16:00;232;449;80;42;145;92;4;87;0;33;97;160;2;176;681;122;237
18.01.2023 17:00;223;480;61;24;151;123;2;75;0;55;84;185;3;177;703;85;274
18.01.2023 18:00;210;449;53;28;98;73;1;50;0;29;55;158;0;88;659;81;171
18.01.2023 19:00;138;279;19;11;49;37;1;23;0;24;31;67;0;62;417;30;86
18.01.2023 20:00;92;161;10;5;39;25;0;9;0;20;21;36;2;33;253;15;64
18.01.2023 21:00;93;158;9;6;25;16;0;5;0;7;26;21;1;14;251;15;41
18.01.2023 22:00;56;117;6;3;25;9;1;0;0;5;14;18;0;5;173;9;34
18.01.2023 23:00;37;53;3;1;8;4;0;1;0;1;3;6;0;1;90;4;12
19.01.2023 00:00;5;20;1;0;1;1;1;2;0;1;3;2;0;2;25;1;2
19.01.2023 01:00;2;11;0;0;2;0;0;0;0;0;0;3;0;1;13;0;2
19.01.2023 02:00;3;4;0;0;1;0;0;0;0;1;0;0;0;1;7;0;1
19.01.2023 03:00;2;4;0;0;1;0;0;0;0;1;0;0;0;1;6;0;1
19.01.2023 04:00;5;7;1;2;3;0;0;0;0;2;2;2;0;2;12;3;3
19.01.2023 05:00;31;26;11;8;23;7;0;2;0;1;6;9;0;2;57;19;30
19.01.2023 06:00;89;100;24;26;43;27;1;15;0;3;42;37;0;23;189;50;70
19.01.2023 07:00;270;259;67;41;112;108;1;59;0;27;76;135;5;98;529;108;220
19.01.2023 08:00;260;248;35;18;119;98;0;58;0;20;62;206;3;95;508;53;217
19.01.2023 09:00;97;119;14;10;47;29;1;24;0;12;30;62;4;27;216;24;76
19.01.2023 10:00;83;99;18;3;27;15;0;7;0;8;22;34;6;23;182;21;42
19.01.2023 11:00;73;108;9;4;15;15;3;4;0;12;21;31;4;22;181;13;30
19.01.2023 12:00;83;150;21;10;27;22;1;11;0;14;37;43;2;35;233;31;49
19.01.2023 13:00;110;194;19;13;45;34;3;34;0;9;31;58;7;34;304;32;79
19.01.2023 14:00;136;233;36;11;43;40;6;34;0;16;44;77;17;52;369;47;83
19.01.2023 15:00;160;306;31;23;72;54;8;54;0;32;61;102;20;79;466;54;126
19.01.2023 16:00;191;350;47;29;103;67;8;52;0;31;71;143;17;105;541;76;170
19.01.2023 17:00;189;398;61;29;112;78;3;54;0;43;66;156;36;116;587;90;190
19.01.2023 18:00;132;317;36;6;83;58;2;32;0;30;55;88;17;82;449;42;141
19.01.2023 19:00;113;239;14;8;35;26;0;14;0;18;36;38;6;46;352;22;61
19.01.2023 20:00;90;153;9;6;25;16;0;9;0;8;18;33;3;29;243;15;41
19.01.2023 21:00;62;87;5;1;17;10;1;4;0;3;20;7;5;14;149;6;27
19.01.2023 22:00;42;124;4;4;12;11;3;3;0;4;6;10;2;10;166;8;23
19.01.2023 23:00;15;37;4;2;9;5;1;4;0;5;6;6;2;4;52;6;14
20.01.2023 00:00;15;14;1;0;2;1;0;0;0;0;6;3;0;1;29;1;3
20.01.2023 01:00;4;14;0;0;2;2;0;0;0;0;1;1;0;2;18;0;4
20.01.2023 02:00;1;7;0;0;2;0;0;0;0;0;0;0;0;0;8;0;2
20.01.2023 03:00;1;1;0;0;1;0;0;0;0;0;6;0;0;0;2;0;1
20.01.2023 04:00;5;11;2;1;2;1;0;1;0;4;3;2;4;0;16;3;3
20.01.2023 05:00;24;28;7;5;8;6;1;5;0;2;7;11;1;6;52;12;14
20.01.2023 06:00;64;82;16;13;33;21;2;12;0;4;24;22;7;15;146;29;54
20.01.2023 07:00;223;233;59;46;96;72;5;33;0;32;77;92;20;96;456;105;168
20.01.2023 08:00;217;253;40;24;103;82;0;60;0;34;52;155;11;91;470;64;185
20.01.2023 09:00;139;163;23;9;45;41;6;34;0;14;42;73;9;44;302;32;86
20.01.2023 10:00;113;169;23;11;24;29;6;19;0;13;33;41;16;43;282;34;53
20.01.2023 11:00;110;220;19;17;26;24;3;45;0;19;39;55;24;60;330;36;50
20.01.2023 12:00;126;244;34;23;48;39;2;38;0;19;65;77;18;72;370;57;87
20.01.2023 13:00;132;282;40;18;50;37;8;30;0;34;61;84;16;57;414;58;87
20.01.2023 14:00;124;273;30;21;54;48;8;29;0;17;44;52;12;36;397;51;102
20.01.2023 15:00;96;216;23;20;49;32;5;19;0;24;59;71;11;54;312;43;81
20.01.2023 16:00;91;229;27;11;41;29;4;34;0;18;41;60;25;32;320;38;70
20.01.2023 17:00;89;226;27;10;45;38;0;25;0;16;47;69;8;51;315;37;83
20.01.2023 18:00;103;212;13;4;45;28;4;13;0;15;28;42;6;37;315;17;73
20.01.2023 19:00;96;179;8;0;20;15;2;10;0;6;21;26;3;27;275;8;35
20.01.2023 20:00;65;106;5;0;14;11;3;0;0;5;11;9;4;15;171;5;25
20.01.2023 21:00;40;72;8;4;11;4;2;6;0;6;11;10;2;15;112;12;15
20.01.2023 22:00;42;71;4;0;3;3;1;4;0;4;10;4;1;2;113;4;6
20.01.2023 23:00;43;55;2;4;4;3;0;3;0;2;13;8;2;6;98;6;7
21.01.2023 00:00;23;36;1;0;7;2;0;8;0;0;5;7;4;8;59;1;9
21.01.2023 01:00;9;25;1;1;1;1;0;0;0;2;4;4;0;2;34;2;2
21.01.2023 02:00;2;13;1;1;0;0;3;0;0;0;3;3;0;3;15;2;0
21.01.2023 03:00;6;12;0;0;1;0;0;0;0;1;0;1;0;1;18;0;1
21.01.2023 04:00;1;6;0;0;2;0;0;0;0;2;1;2;0;1;7;0;2
21.01.2023 05:00;5;11;2;0;4;2;0;0;0;0;0;3;0;2;16;2;6
21.01.2023 06:00;9;10;2;1;1;3;2;0;0;0;5;3;0;4;19;3;4
21.01.2023 07:00;9;21;3;4;6;2;0;4;0;2;5;7;1;4;30;7;8
21.01.2023 08:00;25;51;10;6;20;10;0;6;0;5;18;14;6;16;76;16;30
21.01.2023 09:00;73;93;3;4;28;13;2;14;0;16;18;19;6;25;166;7;41
21.01.2023 10:00;81;118;17;7;34;28;5;19;0;23;24;36;11;34;199;24;62
21.01.2023 11:00;110;171;22;13;28;20;13;23;0;20;20;34;13;54;281;35;48
21.01.2023 12:00;113;179;18;8;38;30;8;33;0;21;21;55;17;62;292;26;68
21.01.2023 13:00;109;175;33;15;22;26;8;44;0;23;37;50;18;62;284;48;48
21.01.2023 14:00;96;192;24;10;32;36;10;27;0;22;22;73;17;49;288;34;68
21.01.2023 15:00;132;167;22;13;40;29;8;37;0;27;31;40;19;49;299;35;69
21.01.2023 16:00;89;173;25;8;29;19;8;37;0;16;29;55;20;42;262;33;48
21.01.2023 17:00;101;179;14;5;22;14;4;22;0;13;31;44;20;30;280;19;36
21.01.2023 18:00;85;146;5;2;21;12;2;9;0;8;18;28;7;28;231;7;33
21.01.2023 19:00;94;109;8;0;7;5;1;5;0;8;9;13;1;18;203;8;12
21.01.2023 20:00;56;109;11;2;13;1;0;2;0;5;10;6;3;5;165;13;14
21.01.2023 21:00;42;76;6;0;13;2;0;2;0;4;4;7;1;6;118;6;15
21.01.2023 22:00;46;59;6;4;3;3;1;2;0;1;9;3;2;3;105;10;6
21.01.2023 23:00;44;72;0;0;7;5;0;0;0;1;5;4;2;4;116;0;12
22.01.2023 00:00;22;42;2;2;5;5;0;0;0;0;2;0;0;5;64;4;10
22.01.2023 01:00;11;40;2;0;2;2;0;0;0;3;4;3;0;5;51;2;4
22.01.2023 02:00;4;25;2;0;2;0;0;0;0;1;1;5;0;2;29;2;2
22.01.2023 03:00;2;15;1;0;0;2;0;0;0;0;1;0;0;0;17;1;2
22.01.2023 04:00;3;3;1;0;2;0;0;0;0;1;0;1;0;0;6;1;2
22.01.2023 05:00;6;8;1;3;1;0;0;0;0;0;1;1;0;0;14;4;1
22.01.2023 06:00;5;3;3;0;5;2;0;0;0;0;0;3;2;1;8;3;7
22.01.2023 07:00;8;10;3;0;4;0;0;6;0;0;4;4;1;1;18;3;4
22.01.2023 08:00;10;28;6;1;8;8;2;7;0;8;8;8;2;12;38;7;16
22.01.2023 09:00;32;43;8;1;22;9;4;10;0;7;4;21;8;22;75;9;31
22.01.2023 10:00;67;76;13;9;24;25;8;18;0;14;13;22;19;42;143;22;49
22.01.2023 11:00;39;77;22;3;20;20;4;23;0;7;23;41;17;39;116;25;40
22.01.2023 12:00;74;123;15;14;28;23;5;38;0;19;16;45;16;51;197;29;51
22.01.2023 13:00;79;121;14;15;40;25;18;42;0;23;19;58;22;56;200;29;65
22.01.2023 14:00;62;125;20;22;47;40;12;42;0;6;10;75;23;57;187;42;87
22.01.2023 15:00;78;129;24;14;24;21;14;33;0;14;28;46;27;41;207;38;45
22.01.2023 16:00;90;144;27;10;20;22;11;24;0;15;27;52;19;48;234;37;42
22.01.2023 17:00;87;129;23;10;27;18;10;35;0;17;20;42;25;37;216;33;45
22.01.2023 18:00;73;100;10;1;14;15;0;17;0;5;22;23;11;27;173;11;29
22.01.2023 19:00;61;95;11;2;21;8;0;4;0;10;15;15;10;17;156;13;29
22.01.2023 20:00;35;71;1;4;11;13;0;9;0;7;11;14;1;18;106;5;24
22.01.2023 21:00;32;51;6;2;10;4;0;3;0;2;11;7;3;9;83;8;14
22.01.2023 22:00;26;26;2;2;3;0;0;3;0;1;5;2;3;5;52;4;3
22.01.2023 23:00;7;17;1;0;3;2;0;2;0;1;3;1;0;0;24;1;5
23.01.2023 00:00;8;9;0;0;1;1;0;0;0;1;0;0;0;2;17;0;2
23.01.2023 01:00;0;3;0;0;2;1;0;0;0;0;0;1;2;0;3;0;3
23.01.2023 02:00;2;2;0;0;4;0;0;1;0;1;1;0;1;1;4;0;4
23.01.2023 03:00;1;2;0;0;3;2;0;0;0;0;0;2;1;0;3;0;5
23.01.2023 04:00;2;10;0;0;4;0;0;0;0;1;2;2;2;1;12;0;4
23.01.2023 05:00;28;26;12;7;12;8;1;4;0;1;11;12;2;4;54;19;20
23.01.2023 06:00;107;94;25;30;44;30;13;13;0;5;34;35;12;29;201;55;74
23.01.2023 07:00;332;292;75;47;150;107;19;77;0;38;79;158;41;152;624;122;257
23.01.2023 08:00;338;321;47;27;155;151;18;108;0;33;76;292;37;122;659;74;306
23.01.2023 09:00;185;223;23;7;60;57;13;52;0;33;52;109;29;60;408;30;117
23.01.2023 10:00;120;161;21;10;29;26;5;37;0;12;33;40;14;42;281;31;55
23.01.2023 11:00;91;155;21;3;31;31;6;35;0;18;39;49;20;41;246;24;62
23.01.2023 12:00;114;170;13;7;48;32;10;40;0;15;49;61;14;48;284;20;80
23.01.2023 13:00;114;268;26;15;56;33;16;43;0;27;48;72;31;87;382;41;89
23.01.2023 14:00;158;243;31;22;61;48;19;49;0;38;53;70;29;85;401;53;109
23.01.2023 15:00;159;306;59;15;81;59;17;69;0;41;63;103;44;74;465;74;140
23.01.2023 16:00;206;450;73;32;129;63;33;61;0;37;83;158;39;94;656;105;192
23.01.2023 17:00;212;463;60;36;132;103;26;67;0;65;83;199;46;156;675;96;235
23.01.2023 18:00;182;372;32;22;103;76;19;41;0;20;47;146;25;73;554;54;179
23.01.2023 19:00;146;254;20;8;55;28;7;30;0;28;44;60;13;67;400;28;83
23.01.2023 20:00;88;171;13;4;31;22;2;8;0;18;23;31;7;31;259;17;53
23.01.2023 21:00;72;141;8;6;18;5;4;5;0;5;19;14;4;17;213;14;23
23.01.2023 22:00;53;87;6;4;11;5;0;4;0;7;15;6;1;10;140;10;16
23.01.2023 23:00;23;32;2;7;9;2;0;2;0;0;14;7;0;3;55;9;11
24.01.2023 00:00;6;8;3;0;0;1;0;0;0;0;3;1;0;0;14;3;1
24.01.2023 01:00;2;5;0;0;2;0;0;1;0;2;1;2;0;0;7;0;2
24.01.2023 02:00;1;1;0;0;1;0;0;0;0;0;0;0;0;0;2;0;1
24.01.2023 03:00;1;10;1;0;1;1;0;0;0;1;1;0;0;1;11;1;2
24.01.2023 04:00;4;7;2;1;0;1;0;0;0;1;2;1;1;2;11;3;1
24.01.2023 05:00;38;31;14;9;19;7;1;3;0;1;16;10;2;4;69;23;26
24.01.2023 06:00;108;109;31;32;58;34;14;19;0;5;36;46;22;22;217;63;92
24.01.2023 07:00;352;317;83;43;139;140;37;101;0;44;108;185;53;143;669;126;279
24.01.2023 08:00;390;367;50;39;198;189;38;138;0;41;93;355;44;143;757;89;387
24.01.2023 09:00;224;216;28;16;85;85;11;79;0;19;47;141;28;65;440;44;170
24.01.2023 10:00;155;165;25;15;40;46;8;35;0;23;45;69;12;53;320;40;86
24.01.2023 11:00;102;193;21;11;36;50;9;35;0;22;42;79;25;73;295;32;86
24.01.2023 12:00;118;215;32;7;56;40;12;26;0;27;45;79;14;61;333;39;96
24.01.2023 13:00;128;332;35;15;73;45;5;48;0;38;51;81;30;101;460;50;118
24.01.2023 14:00;126;296;37;17;69;47;14;40;0;21;62;82;28;79;422;54;116
24.01.2023 15:00;192;311;67;25;83;66;21;59;0;47;60;123;37;97;503;92;149
24.01.2023 16:00;212;402;99;36;117;107;30;99;0;46;110;165;52;114;614;135;224
24.01.2023 17:00;238;464;77;31;159;112;29;82;0;56;78;231;46;140;702;108;271
24.01.2023 18:00;198;399;54;25;111;82;20;62;0;26;55;156;39;86;597;79;193
24.01.2023 19:00;110;269;20;5;48;34;8;28;0;19;49;56;25;51;379;25;82
24.01.2023 20:00;88;162;22;2;23;15;7;20;0;13;15;34;11;27;250;24;38
24.01.2023 21:00;59;136;11;3;11;14;0;10;0;9;21;14;8;17;195;14;25
24.01.2023 22:00;56;97;9;3;8;7;0;4;0;1;20;14;1;13;153;12;15
24.01.2023 23:00;16;32;5;3;8;2;0;2;0;4;12;5;3;5;48;8;10
25.01.2023 00:00;5;7;1;0;2;1;0;2;0;0;3;0;0;3;12;1;3
25.01.2023 01:00;3;7;0;0;0;0;3;0;0;1;0;0;0;2;10;0;0
25.01.2023 02:00;3;2;0;0;2;0;0;1;0;2;1;1;0;1;5;0;2
25.01.2023 03:00;2;4;0;0;3;1;0;0;0;0;1;0;1;0;6;0;4
25.01.2023 04:00;5;8;2;0;3;0;0;0;0;0;2;1;1;3;13;2;3
25.01.2023 05:00;28;34;8;7;17;10;1;5;0;1;14;12;1;4;62;15;27
25.01.2023 06:00;99;104;24;33;61;36;21;22;0;7;37;46;22;33;203;57;97
25.01.2023 07:00;319;279;85;48;139;132;30;86;0;35;85;167;48;126;598;133;271
25.01.2023 08:00;350;349;70;36;187;160;32;116;0;41;78;309;49;148;699;106;347
25.01.2023 09:00;173;199;24;19;80;71;12;64;0;28;57;159;28;71;372;43;151
25.01.2023 10:00;117;178;11;10;33;39;12;24;0;18;30;51;11;66;295;21;72
25.01.2023 11:00;108;178;22;9;35;33;5;28;0;9;41;59;21;62;286;31;68
25.01.2023 12:00;126;250;13;17;53;55;9;39;0;31;25;74;21;57;376;30;108
25.01.2023 13:00;126;271;31;12;52;49;26;50;0;25;56;87;24;68;397;43;101
25.01.2023 14:00;136;259;23;14;67;54;19;43;0;28;46;85;24;51;395;37;121
25.01.2023 15:00;163;291;41;12;84;69;16;67;0;32;70;100;34;74;454;53;153
25.01.2023 16:00;180;434;82;28;108;96;23;75;0;31;84;163;43;104;614;110;204
25.01.2023 17:00;178;458;70;29;136;127;28;100;0;46;84;219;45;130;636;99;263
25.01.2023 18:00;173;342;44;27;104;62;13;48;0;24;61;141;34;84;515;71;166
25.01.2023 19:00;140;266;22;10;57;37;6;25;0;11;32;67;12;68;406;32;94
25.01.2023 20:00;92;177;10;5;33;21;3;6;0;11;18;35;1;38;269;15;54
25.01.2023 21:00;76;130;7;4;20;12;0;6;0;6;14;27;4;21;206;11;32
25.01.2023 22:00;76;113;5;4;17;13;1;6;0;4;25;17;0;16;189;9;30
25.01.2023 23:00;18;42;3;5;8;3;0;2;0;0;9;6;0;10;60;8;11
26.01.2023 00:00;7;10;2;0;3;3;1;0;0;0;2;2;0;1;17;2;6
26.01.2023 01:00;5;18;1;1;1;1;0;1;0;0;0;3;0;1;23;2;2
26.01.2023 02:00;2;1;0;0;1;1;0;0;0;1;0;0;0;1;3;0;2
26.01.2023 03:00;2;1;0;0;1;0;0;0;0;0;2;0;0;0;3;0;1
26.01.2023 04:00;3;8;2;2;2;0;0;0;0;0;5;3;1;1;11;4;2
26.01.2023 05:00;25;26;5;5;14;13;2;5;0;0;8;9;2;4;51;10;27
26.01.2023 06:00;69;84;25;14;38;27;12;20;0;5;34;31;12;21;153;39;65
26.01.2023 07:00;242;257;54;35;97;94;17;58;0;32;69;126;35;126;499;89;191
26.01.2023 08:00;317;315;55;19;158;130;18;102;0;32;71;240;30;121;632;74;288
26.01.2023 09:00;145;173;20;11;65;49;9;46;0;14;49;109;19;44;318;31;114
26.01.2023 10:00;115;138;11;15;23;33;8;15;0;19;26;49;14;37;253;26;56
26.01.2023 11:00;76;144;10;5;30;26;3;28;0;11;31;36;18;43;220;15;56
26.01.2023 12:00;97;178;20;6;34;20;4;32;0;12;52;61;11;30;275;26;54
26.01.2023 13:00;109;222;28;8;50;39;12;34;0;26;32;52;17;50;331;36;89
26.01.2023 14:00;119;227;15;9;49;31;12;28;0;16;33;52;21;34;346;24;80
26.01.2023 15:00;119;280;30;12;72;70;11;49;0;19;46;95;19;39;399;42;142
26.01.2023 16:00;162;339;42;23;91;71;17;50;0;22;66;93;28;80;501;65;162
26.01.2023 17:00;146;347;38;22;99;62;13;40;0;23;52;140;34;99;493;60;161
26.01.2023 18:00;148;291;38;10;75;44;7;24;0;32;39;108;22;63;439;48;119
26.01.2023 19:00;98;220;15;7;33;26;3;17;0;10;20;38;9;43;318;22;59
26.01.2023 20:00;66;110;13;5;17;6;0;7;0;9;9;22;6;16;176;18;23
26.01.2023 21:00;47;102;4;4;11;8;1;10;0;5;13;8;8;9;149;8;19
26.01.2023 22:00;39;100;3;2;5;1;1;4;0;5;17;9;0;5;139;5;6
26.01.2023 23:00;12;42;3;4;2;3;0;4;0;2;9;5;3;2;54;7;5
27.01.2023 00:00;6;19;1;1;2;1;0;0;0;1;2;2;0;2;25;2;3
27.01.2023 01:00;5;7;0;0;2;1;0;1;0;0;0;1;1;0;12;0;3
27.01.2023 02:00;1;1;0;0;3;1;0;1;0;0;1;0;1;2;2;0;4
27.01.2023 03:00;0;3;0;0;3;0;0;0;0;2;0;0;0;0;3;0;3
27.01.2023 04:00;3;4;2;1;1;1;0;0;0;0;2;2;1;1;7;3;2
27.01.2023 05:00;17;22;9;5;8;8;1;4;0;1;6;8;1;4;39;14;16
27.01.2023 06:00;57;69;19;17;30;20;9;10;0;3;31;19;11;14;126;36;50
27.01.2023 07:00;218;220;54;39;84;80;19;44;0;40;66;95;23;94;438;93;164
27.01.2023 08:00;233;250;39;14;98;107;11;81;0;36;73;170;31;93;483;53;205
27.01.2023 09:00;163;182;13;7;54;49;5;31;0;19;39;87;10;56;345;20;103
27.01.2023 10:00;107;148;19;7;30;27;8;27;0;22;35;40;20;53;255;26;57
27.01.2023 11:00;96;200;16;8;29;25;7;32;0;22;40;55;20;68;296;24;54
27.01.2023 12:00;157;231;37;13;57;27;8;37;0;18;54;75;27;62;388;50;84
27.01.2023 13:00;137;318;28;20;54;51;19;48;0;34;66;100;20;85;455;48;105
27.01.2023 14:00;135;321;39;27;74;58;21;56;0;44;65;101;32;100;456;66;132
27.01.2023 15:00;142;335;45;35;69;69;23;57;0;28;61;98;32;80;477;80;138
27.01.2023 16:00;156;312;43;23;85;60;28;71;0;32;53;113;39;95;468;66;145
27.01.2023 17:00;148;337;41;20;82;61;14;57;0;45;68;127;38;89;485;61;143
27.01.2023 18:00;148;292;29;12;70;43;12;49;0;12;45;104;23;48;440;41;113
27.01.2023 19:00;124;297;11;12;34;20;1;22;0;8;43;41;7;41;421;23;54
27.01.2023 20:00;92;135;9;1;22;8;0;12;0;5;21;28;5;19;227;10;30
27.01.2023 21:00;71;109;1;2;19;11;1;8;0;6;15;14;5;21;180;3;30
27.01.2023 22:00;66;94;10;1;14;3;0;4;0;3;17;11;3;15;160;11;17
27.01.2023 23:00;50;104;5;2;10;6;0;3;0;4;9;8;0;6;154;7;16
28.01.2023 00:00;28;58;1;2;8;5;0;2;0;2;8;12;0;7;86;3;13
28.01.2023 01:00;14;32;4;0;3;0;3;1;0;3;0;7;1;2;46;4;3
28.01.2023 02:00;11;14;0;0;3;4;0;2;0;1;8;4;1;2;25;0;7
28.01.2023 03:00;5;17;1;1;4;1;0;2;0;1;1;1;0;1;22;2;5
28.01.2023 04:00;3;6;1;1;1;2;0;0;0;0;1;2;0;0;9;2;3
28.01.2023 05:00;9;14;0;4;4;3;1;1;0;0;6;4;1;2;23;4;7
28.01.2023 06:00;7;17;4;0;4;2;1;2;0;0;7;3;1;1;24;4;6
28.01.2023 07:00;13;29;4;6;8;4;2;3;0;2;9;5;6;5;42;10;12
28.01.2023 08:00;25;53;8;7;10;10;5;5;0;8;14;16;10;22;78;15;20
28.01.2023 09:00;90;127;14;4;26;20;8;20;0;18;28;35;16;35;217;18;46
28.01.2023 10:00;96;179;16;11;28;17;11;26;0;15;16;38;34;44;275;27;45
28.01.2023 11:00;109;209;16;8;30;25;10;55;0;26;35;41;27;90;318;24;55
28.01.2023 12:00;144;237;30;13;48;44;19;45;0;24;39;75;35;59;381;43;92
28.01.2023 13:00;119;262;34;25;39;36;12;45;0;19;37;94;30;95;381;59;75
28.01.2023 14:00;120;260;31;16;32;48;25;66;0;20;26;89;39;71;380;47;80
28.01.2023 15:00;140;236;44;21;63;43;17;57;0;33;34;90;36;111;376;65;106
28.01.2023 16:00;127;233;36;19;47;32;19;64;0;29;28;82;39;132;360;55;79
28.01.2023 17:00;113;234;24;10;34;28;10;50;0;23;29;66;35;66;347;34;62
28.01.2023 18:00;107;196;15;9;21;23;1;26;0;16;16;48;23;35;303;24;44
28.01.2023 19:00;98;158;6;1;10;11;5;9;0;7;21;29;4;17;256;7;21
28.01.2023 20:00;72;102;8;1;10;6;4;12;0;6;9;11;6;14;174;9;16
28.01.2023 21:00;42;70;6;2;12;3;2;2;0;4;20;2;3;15;112;8;15
28.01.2023 22:00;44;92;8;1;10;5;0;2;0;2;3;10;2;7;136;9;15
28.01.2023 23:00;41;52;3;1;6;5;0;5;0;1;7;8;2;5;93;4;11
29.01.2023 00:00;35;68;2;2;6;4;3;2;0;0;6;4;0;7;103;4;10
29.01.2023 01:00;20;35;0;1;3;3;0;5;0;0;4;6;1;8;55;1;6
29.01.2023 02:00;12;23;0;1;4;0;0;3;0;3;0;1;1;4;35;1;4
29.01.2023 03:00;10;19;2;3;0;0;2;0;0;0;1;1;1;1;29;5;0
29.01.2023 04:00;2;8;2;0;0;2;0;1;0;0;0;1;0;0;10;2;2
29.01.2023 05:00;5;3;0;6;3;4;0;1;0;0;3;2;3;0;8;6;7
29.01.2023 06:00;6;13;0;1;2;0;1;0;0;0;4;1;1;1;19;1;2
29.01.2023 07:00;6;16;3;2;5;1;0;3;0;0;3;2;1;1;22;5;6
29.01.2023 08:00;21;28;13;0;8;12;3;8;0;3;6;11;11;18;49;13;20
29.01.2023 09:00;38;55;14;2;23;17;8;25;0;9;11;19;16;30;93;16;40
29.01.2023 10:00;76;89;16;9;16;20;10;31;0;6;21;44;26;30;165;25;36
29.01.2023 11:00;47;92;22;11;26;31;17;33;0;9;13;40;22;49;139;33;57
29.01.2023 12:00;87;102;37;9;36;26;21;51;0;14;26;56;26;83;189;46;62
29.01.2023 13:00;96;159;37;23;65;46;18;53;0;15;21;79;52;73;255;60;111
29.01.2023 14:00;107;172;57;36;66;72;23;68;0;25;24;96;52;124;279;93;138
29.01.2023 15:00;130;167;48;34;63;56;23;95;0;37;28;117;47;128;297;82;119
29.01.2023 16:00;126;138;37;15;60;42;27;53;0;28;36;88;49;97;264;52;102
29.01.2023 17:00;113;156;21;8;37;27;6;31;0;15;17;43;28;56;269;29;64
29.01.2023 18:00;80;118;6;4;18;9;3;13;0;11;19;23;8;27;198;10;27
29.01.2023 19:00;75;101;8;2;21;3;1;5;0;5;17;7;3;9;176;10;24
29.01.2023 20:00;41;53;6;4;10;6;0;6;0;3;10;14;8;11;94;10;16
29.01.2023 21:00;31;49;3;1;11;7;0;2;0;7;9;4;3;4;80;4;18
29.01.2023 22:00;23;42;1;0;2;0;0;4;0;0;9;1;0;4;65;1;2
29.01.2023 23:00;8;17;0;0;7;5;0;0;0;0;3;2;0;3;25;0;12
30.01.2023 00:00;4;16;1;1;2;0;0;0;0;1;2;0;0;2;20;2;2
30.01.2023 01:00;0;3;0;0;4;0;0;0;0;1;1;0;0;1;3;0;4
30.01.2023 02:00;1;3;0;0;3;1;0;0;0;0;3;0;0;1;4;0;4
30.01.2023 03:00;1;3;0;0;2;0;0;0;0;0;0;0;0;1;4;0;2
30.01.2023 04:00;6;6;1;0;3;1;0;0;0;0;3;2;1;0;12;1;4
30.01.2023 05:00;27;30;12;7;23;8;2;5;0;2;10;15;5;11;57;19;31
30.01.2023 06:00;93;92;18;30;50;30;13;17;0;7;42;38;18;20;185;48;80
30.01.2023 07:00;287;240;52;48;121;110;31;63;0;36;62;146;35;118;527;100;231
30.01.2023 08:00;307;253;49;27;144;150;19;94;0;28;84;216;38;89;560;76;294
30.01.2023 09:00;130;185;25;5;50;46;6;34;0;20;33;110;14;52;315;30;96
30.01.2023 10:00;91;143;12;7;20;21;3;26;0;20;34;39;15;36;234;19;41
30.01.2023 11:00;109;175;21;5;24;33;10;26;0;21;28;50;25;48;284;26;57
30.01.2023 12:00;120;180;16;5;33;32;11;41;0;23;36;47;23;46;300;21;65
30.01.2023 13:00;121;268;19;21;53;48;17;28;0;25;52;83;12;39;389;40;101
30.01.2023 14:00;130;272;23;16;50;52;10;30;0;23;46;67;19;55;402;39;102
30.01.2023 15:00;152;273;39;19;63;62;17;52;0;30;64;81;32;59;425;58;125
30.01.2023 16:00;214;379;62;23;99;87;25;60;0;34;87;148;34;135;593;85;186
30.01.2023 17:00;209;490;59;23;120;108;17;78;0;47;73;193;54;123;699;82;228
30.01.2023 18:00;177;426;36;24;93;60;13;52;0;25;76;136;35;74;603;60;153
30.01.2023 19:00;124;289;11;8;47;26;5;20;0;18;43;68;11;55;413;19;73
30.01.2023 20:00;80;148;6;2;32;11;1;11;0;7;35;30;8;13;228;8;43
30.01.2023 21:00;51;123;4;1;9;13;2;3;0;5;20;17;4;14;174;5;22
30.01.2023 22:00;44;71;1;3;8;6;0;6;0;10;19;15;1;4;115;4;14
30.01.2023 23:00;13;35;0;4;7;1;0;1;0;3;10;8;0;4;48;4;8
31.01.2023 00:00;4;11;2;0;2;5;2;0;0;0;1;2;0;0;15;2;7
31.01.2023 01:00;2;3;0;0;0;1;0;0;0;0;0;0;0;1;5;0;1
31.01.2023 02:00;4;4;0;0;1;0;0;0;0;1;0;0;0;0;8;0;1
31.01.2023 03:00;0;4;0;0;1;1;0;0;0;0;3;0;0;0;4;0;2
31.01.2023 04:00;6;7;0;0;2;1;0;1;0;0;6;2;2;1;13;0;3
31.01.2023 05:00;29;25;12;6;23;9;1;8;0;1;15;14;2;4;54;18;32
31.01.2023 06:00;120;95;33;34;54;42;13;31;0;5;35;38;21;26;215;67;96
31.01.2023 07:00;320;318;65;54;146;123;28;98;0;48;94;163;52;139;638;119;269
31.01.2023 08:00;320;386;73;31;203;188;25;120;0;34;94;329;37;153;706;104;391
31.01.2023 09:00;188;224;30;17;86;79;13;57;0;26;54;143;20;64;412;47;165
31.01.2023 10:00;112;155;40;12;44;30;8;43;0;16;47;46;30;57;267;52;74
31.01.2023 11:00;78;192;27;7;55;38;7;35;0;19;26;57;21;60;270;34;93
31.01.2023 12:00;125;218;28;9;36;28;12;44;0;27;52;74;21;40;343;37;64
31.01.2023 13:00;135;295;24;14;71;57;10;58;0;41;69;73;33;69;430;38;128
31.01.2023 14:00;130;260;38;19;61;49;16;52;0;31;47;76;33;80;390;57;110
31.01.2023 15:00;168;352;47;26;95;68;14;51;0;51;58;113;34;76;520;73;163
31.01.2023 16:00;221;384;63;19;136;105;29;92;0;43;90;161;46;85;605;82;241
31.01.2023 17:00;224;450;63;31;121;106;12;73;0;27;88;179;52;97;674;94;227
31.01.2023 18:00;171;358;40;16;109;76;11;54;0;32;60;150;35;69;529;56;185
31.01.2023 19:00;140;265;18;10;56;35;5;15;0;12;44;63;10;63;405;28;91
31.01.2023 20:00;84;161;11;8;20;18;4;13;0;12;24;20;4;26;245;19;38
31.01.2023 21:00;55;134;9;0;28;13;0;13;0;9;15;15;12;18;189;9;41
31.01.2023 22:00;44;127;5;3;6;7;0;4;0;6;9;16;1;12;171;8;13
31.01.2023 23:00;15;36;0;4;7;4;0;3;0;4;11;4;0;3;51;4;11
01.02.2023 00:00;7;13;0;1;0;0;1;0;0;0;6;0;0;2;20;1;0
01.02.2023 01:00;2;10;0;1;3;1;0;0;0;2;2;1;0;0;12;1;4
01.02.2023 02:00;2;7;0;0;2;0;0;0;0;1;1;0;0;0;9;0;2
01.02.2023 03:00;1;4;0;0;2;1;0;0;0;1;3;0;0;0;5;0;3
01.02.2023 04:00;3;6;0;0;5;0;0;0;0;0;2;1;2;2;9;0;5
01.02.2023 05:00;36;34;10;3;19;10;2;5;0;1;16;12;2;4;70;13;29
01.02.2023 06:00;103;116;19;27;50;30;13;17;0;6;42;41;20;18;219;46;80
01.02.2023 07:00;324;300;73;48;126;123;38;90;0;37;85;164;54;132;624;121;249
01.02.2023 08:00;405;342;64;38;205;177;31;117;0;41;101;320;52;156;747;102;382
01.02.2023 09:00;154;204;22;14;92;101;8;55;0;32;59;131;21;52;358;36;193
01.02.2023 10:00;118;156;12;10;37;33;8;39;0;18;28;59;34;43;274;22;70
01.02.2023 11:00;99;204;21;13;38;32;15;40;0;23;39;63;30;49;303;34;70
01.02.2023 12:00;124;246;20;10;57;43;20;45;0;29;40;89;36;58;370;30;100
01.02.2023 13:00;156;282;26;17;68;46;14;47;0;24;45;89;36;55;438;43;114
01.02.2023 14:00;128;290;29;26;54;53;14;48;0;36;70;95;33;46;418;55;107
01.02.2023 15:00;129;311;40;19;89;62;20;66;0;20;52;81;23;66;440;59;151
01.02.2023 16:00;189;384;68;29;104;110;28;86;0;40;87;138;41;102;573;97;214
01.02.2023 17:00;172;446;51;20;144;108;23;77;0;49;70;175;50;115;618;71;252
01.02.2023 18:00;157;314;39;21;96;65;11;54;0;23;46;154;28;65;471;60;161
01.02.2023 19:00;119;261;20;8;47;41;6;19;0;18;30;57;9;58;380;28;88
01.02.2023 20:00;75;151;10;3;23;15;2;10;0;6;29;19;4;21;226;13;38
01.02.2023 21:00;54;102;6;2;14;6;2;7;0;5;13;12;6;21;156;8;20
01.02.2023 22:00;49;85;1;3;12;8;1;3;0;5;12;8;0;7;134;4;20
01.02.2023 23:00;22;37;1;1;4;9;0;4;0;0;7;7;1;5;59;2;13
02.02.2023 00:00;10;13;2;0;2;1;0;1;0;0;4;1;0;0;23;2;3
02.02.2023 01:00;5;8;0;0;2;1;0;1;0;0;0;2;0;1;13;0;3
02.02.2023 02:00;4;3;0;0;1;0;0;0;0;0;0;0;0;0;7;0;1
02.02.2023 03:00;0;2;0;0;2;0;0;0;0;0;2;0;0;0;2;0;2
02.02.2023 04:00;3;6;0;2;3;0;0;0;0;2;4;1;1;0;9;2;3
02.02.2023 05:00;23;24;11;4;18;7;2;6;0;1;15;7;2;8;47;15;25
02.02.2023 06:00;80;88;14;22;44;30;10;18;0;2;33;32;12;12;168;36;74
02.02.2023 07:00;277;251;57;41;109;109;24;66;0;38;80;133;47;119;528;98;218
02.02.2023 08:00;328;308;60;27;170;146;25;117;0;26;67;261;35;110;636;87;316
02.02.2023 09:00;156;186;22;7;62;67;5;42;0;23;49;103;18;49;342;29;129
02.02.2023 10:00;91;148;8;6;19;33;4;26;0;15;33;33;16;42;239;14;52
02.02.2023 11:00;97;166;11;11;18;22;7;18;0;10;34;28;22;25;263;22;40
02.02.2023 12:00;107;168;17;9;38;31;9;25;0;31;35;59;20;35;275;26;69
02.02.2023 13:00;122;226;18;10;47;41;9;32;0;23;50;61;19;43;348;28;88
02.02.2023 14:00;115;262;29;13;54;43;9;48;0;28;52;70;26;53;377;42;97
02.02.2023 15:00;146;298;41;14;91;72;18;85;0;41;48;124;42;77;444;55;163
02.02.2023 16:00;204;374;64;20;105;82;21;85;0;36;93;148;37;107;578;84;187
02.02.2023 17:00;181;474;50;33;139;102;24;86;0;43;62;199;61;109;655;83;241
02.02.2023 18:00;156;389;43;24;81;67;19;46;0;30;42;139;30;79;545;67;148
02.02.2023 19:00;142;289;14;8;63;38;3;14;0;20;51;72;14;70;431;22;101
02.02.2023 20:00;86;152;9;5;24;27;1;15;0;8;16;36;11;37;238;14;51
02.02.2023 21:00;48;119;8;3;17;15;1;13;0;4;18;15;8;20;167;11;32
02.02.2023 22:00;69;112;5;3;14;10;0;15;0;2;21;16;5;10;181;8;24
02.02.2023 23:00;36;48;3;4;7;4;1;0;0;1;5;10;3;8;84;7;11
03.02.2023 00:00;11;23;3;1;3;3;0;1;0;0;3;3;3;3;34;4;6
03.02.2023 01:00;5;12;2;0;0;2;0;0;0;0;5;0;0;0;17;2;2
03.02.2023 02:00;3;8;0;0;2;0;0;0;0;0;2;0;0;0;11;0;2
03.02.2023 03:00;2;5;0;0;2;1;0;0;0;1;1;0;0;0;7;0;3
03.02.2023 04:00;2;8;2;0;4;1;0;1;0;0;6;2;1;0;10;2;5
03.02.2023 05:00;32;28;9;4;14;8;3;4;0;2;14;13;3;6;60;13;22
03.02.2023 06:00;81;96;23;22;36;26;11;14;0;1;37;27;9;25;177;45;62
03.02.2023 07:00;261;272;59;51;92;108;30;79;0;37;80;111;42;118;533;110;200
03.02.2023 08:00;271;274;35;18;132;87;20;95;0;34;69;210;35;99;545;53;219
03.02.2023 09:00;172;205;28;15;74;61;14;49;0;24;60;122;34;63;377;43;135
03.02.2023 10:00;120;212;20;5;31;32;6;35;0;21;37;57;18;61;332;25;63
03.02.2023 11:00;119;218;18;11;39;39;14;43;0;19;51;73;29;55;337;29;78
03.02.2023 12:00;169;263;30;25;54;33;10;37;0;30;79;74;33;63;432;55;87
03.02.2023 13:00;185;335;41;11;71;58;13;49;0;25;72;86;26;55;520;52;129
03.02.2023 14:00;165;363;32;24;78;65;21;45;0;28;77;96;32;75;528;56;143
03.02.2023 15:00;182;317;45;15;88;67;19;67;0;33;78;112;38;71;499;60;155
03.02.2023 16:00;136;307;44;14;105;52;20;58;0;31;55;113;27;76;443;58;157
03.02.2023 17:00;125;352;38;14;64;50;16;55;0;25;58;124;49;74;477;52;114
03.02.2023 18:00;110;253;22;8;58;30;9;41;0;8;40;65;22;50;363;30;88
03.02.2023 19:00;113;223;7;6;31;21;7;16;0;8;45;36;15;37;336;13;52
03.02.2023 20:00;68;99;12;3;21;7;6;12;0;21;22;17;2;24;167;15;28
03.02.2023 21:00;50;100;4;2;12;7;2;5;0;4;7;11;4;15;150;6;19
03.02.2023 22:00;46;99;4;1;7;7;0;6;0;2;14;13;3;9;145;5;14
03.02.2023 23:00;35;64;3;4;9;3;0;6;0;1;10;15;3;6;99;7;12
04.02.2023 00:00;29;61;4;2;5;3;0;4;0;2;8;4;1;5;90;6;8
04.02.2023 01:00;19;40;2;1;4;1;1;2;0;2;4;5;0;2;59;3;5
04.02.2023 02:00;1;28;2;0;3;0;0;1;0;1;3;0;1;2;29;2;3
04.02.2023 03:00;5;12;1;0;4;1;0;0;0;1;5;0;0;1;17;1;5
04.02.2023 04:00;3;3;1;0;0;0;0;0;0;0;1;1;0;1;6;1;0
04.02.2023 05:00;7;12;1;0;5;1;2;3;0;0;3;4;0;0;19;1;6
04.02.2023 06:00;12;17;2;1;5;3;0;0;0;3;4;3;1;3;29;3;8
04.02.2023 07:00;16;27;6;4;6;3;4;2;0;4;13;10;0;5;43;10;9
04.02.2023 08:00;37;48;14;8;25;15;11;12;0;4;28;22;9;21;85;22;40
04.02.2023 09:00;82;126;14;8;26;27;10;26;0;25;32;32;22;53;208;22;53
04.02.2023 10:00;114;196;26;7;30;34;16;46;0;34;55;67;31;75;310;33;64
04.02.2023 11:00;141;220;35;12;38;47;25;59;0;28;48;85;57;79;361;47;85
04.02.2023 12:00;150;254;43;30;60;52;45;84;0;34;78;127;75;117;404;73;112
04.02.2023 13:00;176;308;55;36;69;50;35;98;0;43;46;129;80;113;484;91;119
04.02.2023 14:00;161;290;42;24;88;69;43;103;0;36;38;182;83;155;451;66;157
04.02.2023 15:00;150;277;51;37;73;67;38;107;0;36;48;151;100;123;427;88;140
04.02.2023 16:00;156;291;55;27;62;87;48;112;0;45;41;129;77;163;447;82;149
04.02.2023 17:00;150;268;37;14;57;49;23;61;0;29;49;118;60;110;418;51;106
04.02.2023 18:00;107;228;25;15;27;31;8;42;0;20;31;63;25;57;335;40;58
04.02.2023 19:00;108;190;7;0;14;14;3;11;0;10;21;40;10;30;298;7;28
04.02.2023 20:00;89;103;8;11;25;4;2;6;0;5;17;29;4;18;192;19;29
04.02.2023 21:00;62;80;6;6;10;0;1;6;0;5;11;21;5;14;142;12;10
04.02.2023 22:00;36;87;9;3;5;3;5;3;0;2;14;9;2;15;123;12;8
04.02.2023 23:00;39;75;2;3;7;4;0;2;0;0;3;13;3;7;114;5;11
05.02.2023 00:00;35;76;7;2;1;9;0;2;0;3;9;14;1;11;111;9;10
05.02.2023 01:00;15;44;1;0;4;5;1;3;0;1;11;21;1;1;59;1;9
05.02.2023 02:00;7;31;1;0;7;3;1;0;0;0;2;7;0;1;38;1;10
05.02.2023 03:00;4;9;0;0;1;2;0;0;0;0;3;2;0;0;13;0;3
05.02.2023 04:00;3;8;0;0;0;1;0;0;0;0;1;2;1;0;11;0;1
05.02.2023 05:00;3;6;1;0;2;1;0;1;0;0;2;2;1;1;9;1;3
05.02.2023 06:00;5;8;2;0;8;1;0;4;0;2;1;3;2;2;13;2;9
05.02.2023 07:00;9;12;1;2;5;0;1;1;0;1;4;3;4;1;21;3;5
05.02.2023 08:00;16;19;9;0;8;7;1;11;0;4;10;12;16;7;35;9;15
05.02.2023 09:00;25;44;7;4;14;14;1;20;0;5;4;21;8;22;69;11;28
05.02.2023 10:00;26;58;7;3;10;9;7;13;0;10;7;9;6;14;84;10;19
05.02.2023 11:00;27;64;12;9;11;16;3;8;0;7;18;20;9;16;91;21;27
05.02.2023 12:00;46;55;18;10;10;12;6;17;0;5;10;28;12;23;101;28;22
05.02.2023 13:00;52;72;13;7;15;15;10;8;0;0;7;28;5;16;124;20;30
05.02.2023 14:00;59;83;20;9;14;17;12;11;0;14;19;23;7;31;142;29;31
05.02.2023 15:00;65;102;18;8;15;15;15;22;0;15;22;43;17;45;167;26;30
05.02.2023 16:00;52;95;14;5;15;18;10;24;0;20;20;36;19;30;147;19;33
05.02.2023 17:00;90;127;17;9;19;17;6;18;0;20;17;44;24;41;217;26;36
05.02.2023 18:00;52;90;10;7;7;11;4;24;0;4;10;28;15;31;142;17;18
05.02.2023 19:00;53;83;6;6;15;5;4;2;0;6;8;6;0;15;136;12;20
05.02.2023 20:00;44;81;4;0;12;5;4;3;0;7;4;13;2;14;125;4;17
05.02.2023 21:00;27;26;3;4;5;4;0;3;0;3;7;1;2;5;53;7;9
05.02.2023 22:00;18;23;3;1;3;7;1;5;0;2;7;2;3;9;41;4;10
05.02.2023 23:00;7;14;1;0;3;1;0;0;0;0;6;0;0;4;21;1;4
06.02.2023 00:00;4;8;0;0;2;0;0;0;0;1;1;0;0;2;12;0;2
06.02.2023 01:00;3;8;0;0;1;0;0;0;0;0;4;0;0;0;11;0;1
06.02.2023 02:00;2;0;2;0;2;0;0;0;0;0;2;1;0;0;2;2;2
06.02.2023 03:00;0;1;1;0;3;0;0;0;0;0;4;0;0;1;1;1;3
06.02.2023 04:00;7;7;3;3;6;1;0;0;0;2;12;2;1;3;14;6;7
06.02.2023 05:00;29;29;13;2;16;8;1;5;0;2;14;14;2;5;58;15;24
06.02.2023 06:00;107;90;21;26;53;28;19;20;0;8;40;52;18;42;197;47;81
06.02.2023 07:00;311;307;65;60;137;137;43;95;0;36;85;157;48;132;618;125;274
06.02.2023 08:00;342;311;54;25;198;159;22;134;0;36;97;276;44;155;653;79;357
06.02.2023 09:00;188;205;22;13;70;64;10;45;0;31;42;141;34;59;393;35;134
06.02.2023 10:00;124;153;20;12;38;37;9;39;0;13;25;71;22;48;277;32;75
06.02.2023 11:00;107;170;24;11;33;38;11;41;0;16;40;65;26;63;277;35;71
06.02.2023 12:00;121;220;16;10;57;38;15;65;0;22;58;80;38;66;341;26;95
06.02.2023 13:00;144;250;41;20;62;48;22;59;0;27;80;101;37;86;394;61;110
06.02.2023 14:00;148;274;37;28;67;63;34;54;0;40;61;101;29;85;422;65;130
06.02.2023 15:00;187;355;52;19;95;84;31;102;0;44;64;136;46;117;542;71;179
06.02.2023 16:00;217;456;75;45;136;101;36;89;0;53;103;182;38;150;673;120;237
06.02.2023 17:00;225;501;63;29;168;131;31;95;0;53;84;239;54;145;726;92;299
06.02.2023 18:00;160;412;42;20;122;86;31;65;0;28;63;172;40;77;572;62;208
06.02.2023 19:00;134;288;18;9;51;42;18;25;0;17;47;60;13;65;422;27;93
06.02.2023 20:00;96;175;12;3;30;20;1;15;0;6;19;38;8;18;271;15;50
06.02.2023 21:00;68;116;6;5;19;13;1;16;0;14;27;28;12;25;184;11;32
06.02.2023 22:00;53;71;14;1;14;9;3;0;0;8;15;13;0;10;124;15;23
06.02.2023 23:00;21;35;2;5;5;2;1;4;0;1;12;4;2;4;56;7;7
07.02.2023 00:00;8;7;1;0;3;0;2;1;0;1;0;0;0;2;15;1;3
07.02.2023 01:00;2;8;0;0;0;1;0;0;0;0;1;1;0;0;10;0;1
07.02.2023 02:00;2;2;0;0;0;0;0;0;0;0;1;0;0;0;4;0;0
07.02.2023 03:00;0;3;0;0;2;0;0;0;0;0;1;0;0;0;3;0;2
07.02.2023 04:00;8;9;1;1;6;2;0;0;0;0;11;2;1;3;17;2;8
07.02.2023 05:00;40;32;14;6;20;8;0;5;0;2;11;13;3;8;72;20;28
07.02.2023 06:00;114;97;30;22;47;26;16;20;0;7;36;42;15;31;211;52;73
07.02.2023 07:00;333;329;67;43;154;123;28;99;0;52;90;197;47;144;662;110;277
07.02.2023 08:00;365;348;70;34;205;171;31;141;0;40;90;310;54;155;713;104;376
07.02.2023 09:00;195;202;26;15;94;76;13;53;0;18;45;151;21;64;397;41;170
07.02.2023 10:00;116;156;18;10;31;31;13;50;0;9;30;80;21;45;272;28;62
07.02.2023 11:00;112;172;21;20;42;34;16;47;0;29;38;72;39;63;284;41;76
07.02.2023 12:00;127;232;29;18;52;45;17;58;0;26;49;95;32;97;359;47;97
07.02.2023 13:00;158;330;36;30;85;57;22;82;0;47;64;105;53;135;488;66;142
07.02.2023 14:00;181;330;52;21;78;89;25;98;0;46;65;133;50;129;511;73;167
07.02.2023 15:00;190;404;60;29;132;103;33;107;0;65;76;178;53;176;594;89;235
07.02.2023 16:00;245;449;100;41;163;142;37;128;0;57;70;209;63;216;694;141;305
07.02.2023 17:00;257;504;85;51;176;149;37;113;0;68;88;233;58;232;761;136;325
07.02.2023 18:00;232;398;54;26;130;90;26;65;0;41;58;167;55;125;630;80;220
07.02.2023 19:00;144;298;34;11;59;37;11;39;0;19;47;66;18;40;442;45;96
07.02.2023 20:00;83;174;11;7;27;27;3;18;0;11;17;22;9;32;257;18;54
07.02.2023 21:00;57;122;12;1;13;12;0;11;0;4;18;20;8;17;179;13;25
07.02.2023 22:00;51;86;3;7;16;9;3;5;0;7;16;10;2;12;137;10;25
07.02.2023 23:00;20;40;3;1;4;3;0;1;0;2;7;7;2;3;60;4;7
08.02.2023 00:00;6;13;5;0;4;1;0;0;0;0;4;0;0;0;19;5;5
08.02.2023 01:00;1;8;0;0;1;0;0;0;0;0;1;0;0;0;9;0;1
08.02.2023 02:00;4;3;0;0;2;0;0;0;0;0;4;0;0;0;7;0;2
08.02.2023 03:00;1;3;1;0;2;0;1;0;0;0;2;0;0;0;4;1;2
08.02.2023 04:00;4;9;4;2;8;0;0;0;0;0;5;3;1;1;13;6;8
08.02.2023 05:00;28;30;8;6;22;5;3;6;0;4;11;13;3;6;58;14;27
08.02.2023 06:00;105;105;27;28;52;20;16;14;0;7;36;33;15;30;210;55;72
08.02.2023 07:00;319;292;62;49;137;115;37;101;0;43;93;178;45;156;611;111;252
08.02.2023 08:00;367;317;56;35;202;164;26;117;0;38;91;315;46;139;684;91;366
08.02.2023 09:00;191;208;28;11;69;76;13;61;0;28;42;160;14;74;399;39;145
08.02.2023 10:00;132;140;21;7;43;35;7;31;0;18;32;47;22;46;272;28;78
08.02.2023 11:00;120;207;31;15;42;35;16;46;0;17;37;70;27;62;327;46;77
08.02.2023 12:00;145;244;28;16;62;40;18;39;0;36;45;84;34;91;389;44;102
08.02.2023 13:00;156;300;39;28;89;70;34;61;0;40;57;123;39;139;456;67;159
08.02.2023 14:00;152;318;44;33;107;69;36;87;0;50;60;142;62;161;470;77;176
08.02.2023 15:00;174;343;63;40;136;93;55;101;0;54;74;170;63;174;517;103;229
08.02.2023 16:00;238;425;111;44;163;108;45;122;0;80;85;204;92;223;663;155;271
08.02.2023 17:00;222;536;84;45;170;134;37;121;0;55;81;258;66;192;758;129;304
08.02.2023 18:00;187;408;48;24;110;101;19;57;0;40;46;149;34;99;595;72;211
08.02.2023 19:00;154;285;33;13;53;42;10;24;0;26;39;74;13;53;439;46;95
08.02.2023 20:00;86;177;22;10;40;31;2;21;0;16;17;30;9;24;263;32;71
08.02.2023 21:00;66;143;11;2;12;10;2;5;0;6;14;28;6;21;209;13;22
08.02.2023 22:00;48;121;10;4;17;17;0;6;0;8;19;19;4;9;169;14;34
08.02.2023 23:00;10;47;2;2;8;13;0;7;0;2;16;6;2;5;57;4;21
09.02.2023 00:00;9;8;3;1;6;3;0;0;0;4;3;1;0;3;17;4;9
09.02.2023 01:00;3;4;0;0;2;0;0;0;0;0;1;1;0;1;7;0;2
09.02.2023 02:00;3;6;1;2;1;0;1;0;0;0;0;0;0;0;9;3;1
09.02.2023 03:00;1;6;2;0;2;0;1;0;0;0;1;0;0;0;7;2;2
09.02.2023 04:00;6;8;2;2;3;0;0;0;0;0;5;6;1;1;14;4;3
09.02.2023 05:00;31;26;12;7;27;6;1;4;0;1;13;8;2;6;57;19;33
09.02.2023 06:00;94;83;26;24;46;22;16;18;0;4;28;35;13;23;177;50;68
09.02.2023 07:00;315;299;55;42;135;139;31;99;0;35;86;162;59;143;614;97;274
09.02.2023 08:00;367;304;58;28;202;175;35;106;0;49;92;294;39;134;671;86;377
09.02.2023 09:00;164;210;27;13;79;56;13;52;0;23;51;126;23;64;374;40;135
09.02.2023 10:00;119;142;18;13;32;33;8;45;0;21;34;66;25;65;261;31;65
09.02.2023 11:00;112;176;15;12;53;29;9;45;0;25;33;76;29;61;288;27;82
09.02.2023 12:00;126;239;33;14;50;37;24;46;0;31;46;83;20;99;365;47;87
09.02.2023 13:00;149;288;21;25;72;43;23;63;0;36;46;99;31;111;437;46;115
09.02.2023 14:00;147;311;40;27;87;70;29;82;0;38;63;117;35;141;458;67;157
09.02.2023 15:00;206;353;49;28;134;57;22;83;0;39;78;147;38;123;559;77;191
09.02.2023 16:00;238;444;80;43;151;128;44;91;0;48;84;203;67;185;682;123;279
09.02.2023 17:00;231;452;73;48;165;131;29;91;0;50;103;216;50;167;683;121;296
09.02.2023 18:00;208;390;57;23;109;81;19;57;0;51;63;149;40;133;598;80;190
09.02.2023 19:00;167;293;20;7;53;37;9;34;0;32;46;69;17;58;460;27;90
09.02.2023 20:00;82;157;13;8;30;8;3;9;0;8;28;35;6;25;239;21;38
09.02.2023 21:00;61;114;6;6;22;12;0;9;0;6;20;23;13;17;175;12;34
09.02.2023 22:00;65;110;3;7;12;10;0;7;0;9;12;15;1;14;175;10;22
09.02.2023 23:00;22;42;3;5;5;4;0;4;0;1;14;6;0;2;64;8;9
10.02.2023 00:00;13;13;3;0;1;2;0;0;0;0;4;3;0;1;26;3;3
10.02.2023 01:00;4;9;0;0;3;0;0;1;0;1;4;1;1;5;13;0;3
10.02.2023 02:00;2;4;0;0;1;0;0;0;0;0;0;0;0;0;6;0;1
10.02.2023 03:00;2;4;0;0;2;1;0;0;0;0;3;0;0;1;6;0;3
10.02.2023 04:00;6;11;1;1;7;1;0;0;0;0;14;1;1;1;17;2;8
10.02.2023 05:00;23;37;12;3;18;10;0;4;0;3;6;9;4;4;60;15;28
10.02.2023 06:00;96;87;21;27;36;29;14;14;0;5;29;25;15;25;183;48;65
10.02.2023 07:00;282;251;55;33;103;90;24;77;0;38;75;132;37;107;533;88;193
10.02.2023 08:00;274;270;60;24;124;108;22;85;0;43;82;210;36;96;544;84;232
10.02.2023 09:00;154;190;19;9;63;51;12;42;0;25;54;107;19;66;344;28;114
10.02.2023 10:00;112;162;16;11;20;31;12;20;0;21;31;59;13;31;274;27;51
10.02.2023 11:00;132;184;25;16;39;36;20;41;0;25;36;57;30;67;316;41;75
10.02.2023 12:00;150;259;51;24;54;40;16;59;0;26;49;88;35;86;409;75;94
10.02.2023 13:00;169;324;49;30;92;58;19;50;0;42;64;114;36;109;493;79;150
10.02.2023 14:00;177;371;55;31;83;73;34;80;0;47;88;140;53;114;548;86;156
10.02.2023 15:00;184;341;63;33;106;83;33;113;0;48;70;142;60;130;525;96;189
10.02.2023 16:00;230;434;65;34;85;101;35;83;0;47;81;195;55;166;664;99;186
10.02.2023 17:00;201;387;51;25;79;79;29;98;0;50;73;167;62;146;588;76;158
10.02.2023 18:00;170;314;31;6;73;53;9;45;0;25;55;119;28;79;484;37;126
10.02.2023 19:00;149;252;22;13;33;33;6;28;0;16;32;48;10;51;401;35;66
10.02.2023 20:00;88;130;13;3;17;6;0;6;0;17;13;17;7;26;218;16;23
10.02.2023 21:00;69;121;10;5;14;9;2;3;0;5;15;15;9;13;190;15;23
10.02.2023 22:00;59;85;4;0;14;9;1;5;0;2;10;17;1;13;144;4;23
10.02.2023 23:00;58;76;3;2;5;6;0;5;0;3;17;7;2;6;134;5;11
11.02.2023 00:00;18;51;3;1;2;2;0;6;0;1;15;7;1;4;69;4;4
11.02.2023 01:00;12;31;1;1;8;4;2;2;0;3;7;6;0;0;43;2;12
11.02.2023 02:00;8;19;1;0;2;0;2;2;0;0;2;3;1;5;27;1;2
11.02.2023 03:00;5;8;2;0;3;0;0;2;0;1;1;0;1;0;13;2;3
11.02.2023 04:00;6;8;0;0;3;2;0;2;0;2;2;2;0;2;14;0;5
11.02.2023 05:00;3;9;4;0;1;3;3;0;0;0;5;2;0;0;12;4;4
11.02.2023 06:00;10;25;4;1;2;2;0;1;0;1;10;2;0;6;35;5;4
11.02.2023 07:00;17;29;5;5;9;2;2;4;0;2;13;6;1;6;46;10;11
11.02.2023 08:00;39;53;13;8;21;14;16;18;0;6;19;33;8;15;92;21;35
11.02.2023 09:00;89;134;19;9;39;17;11;32;0;15;40;39;27;52;223;28;56
11.02.2023 10:00;114;155;16;25;32;20;15;24;0;29;18;58;20;56;269;41;52
11.02.2023 11:00;105;192;42;12;42;24;22;34;0;23;32;62;20;67;297;54;66
11.02.2023 12:00;113;257;31;24;40;49;30;58;0;22;46;76;38;94;370;55;89
11.02.2023 13:00;149;257;26;26;47;57;34;54;0;35;45;96;46;84;406;52;104
11.02.2023 14:00;152;294;46;28;42;60;51;49;0;41;54;73;39;89;446;74;102
11.02.2023 15:00;130;227;29;20;42;30;53;62;0;30;29;71;64;86;357;49;72
11.02.2023 16:00;85;228;32;12;39;45;23;46;0;20;32;73;55;56;313;44;84
11.02.2023 17:00;119;241;24;11;28;32;12;42;0;32;38;51;32;86;360;35;60
11.02.2023 18:00;88;229;21;10;34;32;3;39;0;11;15;54;11;46;317;31;66
11.02.2023 19:00;76;154;11;2;23;10;2;8;0;5;23;26;11;25;230;13;33
11.02.2023 20:00;81;103;8;1;9;6;0;5;0;9;24;22;5;18;184;9;15
11.02.2023 21:00;57;75;2;3;5;7;0;10;0;6;5;14;3;7;132;5;12
11.02.2023 22:00;20;78;2;0;7;5;1;3;0;4;5;4;0;11;98;2;12
11.02.2023 23:00;34;56;3;0;15;10;0;2;0;2;5;10;2;1;90;3;25
12.02.2023 00:00;21;54;3;0;9;1;0;2;0;2;7;3;3;10;75;3;10
12.02.2023 01:00;9;35;2;3;6;0;0;2;0;6;3;2;0;6;44;5;6
12.02.2023 02:00;8;15;2;0;2;0;0;0;0;0;4;0;0;2;23;2;2
12.02.2023 03:00;2;9;0;0;1;0;0;0;0;1;7;1;0;1;11;0;1
12.02.2023 04:00;5;4;2;0;4;0;1;1;0;1;1;2;1;2;9;2;4
12.02.2023 05:00;7;8;2;1;1;3;1;2;0;0;3;3;1;1;15;3;4
12.02.2023 06:00;9;12;2;1;2;6;1;3;0;1;2;5;2;5;21;3;8
12.02.2023 07:00;13;10;6;1;5;4;0;6;0;3;5;8;8;8;23;7;9
12.02.2023 08:00;23;45;11;2;7;19;6;21;0;6;16;19;17;24;68;13;26
12.02.2023 09:00;37;88;21;6;37;30;17;35;0;13;19;28;23;36;125;27;67
12.02.2023 10:00;82;110;29;21;48;42;21;44;0;30;25;80;32;77;192;50;90
12.02.2023 11:00;59;142;47;27;49;38;34;65;0;16;16;68;49;96;201;74;87
12.02.2023 12:00;132;146;56;30;56;72;49;89;0;18;30;119;65;151;278;86;128
12.02.2023 13:00;134;154;77;36;70;85;51;111;0;46;29;132;88;138;288;113;155
12.02.2023 14:00;154;231;51;47;88;101;32;109;0;45;40;147;98;150;385;98;189
12.02.2023 15:00;140;179;72;31;87;83;37;105;0;36;37;154;93;165;319;103;170
12.02.2023 16:00;132;162;54;28;66;70;50;95;0;39;27;137;73;132;294;82;136
12.02.2023 17:00;118;168;35;22;60;52;19;73;0;24;41;101;60;102;286;57;112
12.02.2023 18:00;99;160;21;17;28;22;10;22;0;22;14;44;18;49;259;38;50
12.02.2023 19:00;73;131;11;6;20;9;3;15;0;6;19;17;11;37;204;17;29
12.02.2023 20:00;47;70;5;4;10;8;1;8;0;11;17;17;5;16;117;9;18
12.02.2023 21:00;29;72;8;4;9;6;1;2;0;2;7;7;4;10;101;12;15
12.02.2023 22:00;37;46;4;2;8;2;1;3;0;0;8;6;1;8;83;6;10
12.02.2023 23:00;12;17;3;0;4;1;0;0;0;3;6;2;1;2;29;3;5
13.02.2023 00:00;5;7;0;0;1;0;0;0;0;0;2;0;0;0;12;0;1
13.02.2023 01:00;4;9;0;0;3;0;0;0;0;0;0;1;0;0;13;0;3
13.02.2023 02:00;1;3;0;0;2;0;0;1;0;1;0;0;1;0;4;0;2
13.02.2023 03:00;3;3;0;0;2;0;0;0;0;0;0;0;0;0;6;0;2
13.02.2023 04:00;15;19;1;3;5;1;0;0;0;1;4;5;0;5;34;4;6
13.02.2023 05:00;31;30;19;14;18;5;4;6;0;2;14;12;3;7;61;33;23
13.02.2023 06:00;122;90;28;35;66;38;20;24;0;10;44;42;24;41;212;63;104
13.02.2023 07:00;362;341;72;63;167;169;48;107;0;42;108;192;63;148;703;135;336
13.02.2023 08:00;389;365;52;23;186;176;40;143;0;49;96;342;50;152;754;75;362
13.02.2023 09:00;193;244;33;10;73;79;20;64;0;24;39;149;43;73;437;43;152
13.02.2023 10:00;128;173;18;13;50;39;10;44;0;19;41;74;34;64;301;31;89
13.02.2023 11:00;137;234;30;21;48;48;27;71;0;29;40;93;48;105;371;51;96
13.02.2023 12:00;147;298;45;29;91;66;26;84;0;31;82;132;51;136;445;74;157
13.02.2023 13:00;171;347;64;31;81;83;36;88;0;63;59;137;79;161;518;95;164
13.02.2023 14:00;188;333;72;36;97;108;39;105;0;40;70;181;79;207;521;108;205
13.02.2023 15:00;262;441;85;40;170;128;39;140;0;91;93;207;82;258;703;125;298
13.02.2023 16:00;307;553;124;54;211;171;63;138;0;75;115;241;82;282;860;178;382
13.02.2023 17:00;331;589;108;53;222;163;48;135;0;88;123;288;87;287;920;161;385
13.02.2023 18:00;257;481;61;29;122;90;27;89;0;42;78;204;53;135;738;90;212
13.02.2023 19:00;127;296;24;15;73;53;8;44;0;21;58;85;14;60;423;39;126
13.02.2023 20:00;115;200;14;2;38;16;7;14;0;8;34;36;7;29;315;16;54
13.02.2023 21:00;85;115;9;4;20;13;3;8;0;9;26;13;5;25;200;13;33
13.02.2023 22:00;47;87;7;4;15;9;1;2;0;7;22;10;3;6;134;11;24
13.02.2023 23:00;17;35;5;4;6;7;1;0;0;0;10;5;1;5;52;9;13
14.02.2023 00:00;8;14;0;1;5;2;0;0;0;1;2;2;0;2;22;1;7
14.02.2023 01:00;3;6;0;0;1;0;0;0;0;0;1;0;0;0;9;0;1
14.02.2023 02:00;2;6;1;2;2;4;0;0;0;0;1;1;0;0;8;3;6
14.02.2023 03:00;2;5;0;0;1;1;2;0;0;0;3;0;0;1;7;0;2
14.02.2023 04:00;5;11;1;1;5;0;2;0;0;0;9;3;3;1;16;2;5
14.02.2023 05:00;52;66;18;13;15;7;5;5;0;2;22;21;8;9;118;31;22
14.02.2023 06:00;170;151;43;47;69;49;19;35;0;13;69;54;26;39;321;90;118
14.02.2023 07:00;535;489;91;86;223;200;64;146;0;92;160;302;77;214;1024;177;423
14.02.2023 08:00;543;508;89;62;296;225;49;174;0;59;130;479;66;235;1051;151;521
14.02.2023 09:00;292;296;35;21;109;109;20;87;0;42;84;233;30;115;588;56;218
14.02.2023 10:00;187;257;59;24;66;60;17;68;0;34;62;110;24;91;444;83;126
14.02.2023 11:00;197;332;30;18;50;53;26;63;0;24;76;119;60;124;529;48;103
14.02.2023 12:00;211;380;60;29;86;78;36;96;0;49;87;172;51;169;591;89;164
14.02.2023 13:00;269;514;77;42;133;110;73;116;0;78;89;202;79;236;783;119;243
14.02.2023 14:00;254;515;76;28;147;116;38;145;0;59;101;221;95;244;769;104;263
14.02.2023 15:00;343;577;123;57;177;161;66;153;0;88;132;268;92;303;920;180;338
14.02.2023 16:00;396;735;159;67;234;176;54;187;0;87;176;346;105;313;1131;226;410
14.02.2023 17:00;438;757;117;74;295;199;61;161;0;100;150;342;95;344;1195;191;494
14.02.2023 18:00;310;595;81;32;139;139;27;109;0;60;103;256;59;186;905;113;278
14.02.2023 19:00;181;411;35;10;85;49;12;39;0;33;86;97;23;63;592;45;134
14.02.2023 20:00;130;225;15;13;40;16;7;21;0;31;56;48;17;51;355;28;56
14.02.2023 21:00;105;153;6;5;26;22;2;14;0;11;41;28;7;29;258;11;48
14.02.2023 22:00;59;129;8;7;22;10;0;8;0;8;28;18;5;11;188;15;32
14.02.2023 23:00;29;71;8;1;13;9;1;3;0;5;23;7;7;11;100;9;22
15.02.2023 00:00;7;22;1;1;4;1;0;1;0;2;3;5;0;3;29;2;5
15.02.2023 01:00;10;20;1;0;1;0;0;0;0;0;3;1;0;0;30;1;1
15.02.2023 02:00;5;8;1;0;2;1;0;0;0;0;2;0;0;0;13;1;3
15.02.2023 03:00;3;6;0;0;1;1;0;0;0;0;2;0;0;0;9;0;2
15.02.2023 04:00;3;7;1;1;5;1;0;3;0;0;7;2;2;2;10;2;6
15.02.2023 05:00;41;38;14;14;15;8;3;4;0;0;14;10;3;7;79;28;23
15.02.2023 06:00;118;100;33;41;51;29;10;32;0;10;60;39;27;31;218;74;80
15.02.2023 07:00;377;338;84;52;179;158;39;118;0;43;102;214;58;159;715;136;337
15.02.2023 08:00;418;393;61;38;239;203;39;141;0;34;98;384;49;159;811;99;442
15.02.2023 09:00;215;224;37;9;78;87;12;75;0;27;53;152;28;80;439;46;165
15.02.2023 10:00;132;164;29;16;48;46;11;44;0;19;37;75;38;68;296;45;94
15.02.2023 11:00;134;243;41;18;56;48;22;67;0;27;63;106;43;99;377;59;104
15.02.2023 12:00;149;312;58;25;65;79;32;62;0;30;49;141;38;146;461;83;144
15.02.2023 13:00;200;359;53;32;103;79;27;92;0;57;64;158;53;186;559;85;182
15.02.2023 14:00;214;396;69;42;126;95;53;110;0;62;84;169;64;187;610;111;221
15.02.2023 15:00;209;442;84;48;160;110;41;120;0;54;80;182;82;198;651;132;270
15.02.2023 16:00;260;545;125;55;209;141;44;133;0;60;104;226;95;222;805;180;350
15.02.2023 17:00;276;602;102;48;172;160;49;118;0;74;110;317;66;230;878;150;332
15.02.2023 18:00;224;509;59;24;140;93;18;107;0;64;72;212;46;138;733;83;233
15.02.2023 19:00;138;277;24;18;56;45;12;28;0;17;34;76;12;58;415;42;101
15.02.2023 20:00;99;175;17;7;48;19;5;12;0;16;29;43;10;24;274;24;67
15.02.2023 21:00;80;161;12;2;23;16;1;8;0;8;13;23;4;27;241;14;39
15.02.2023 22:00;55;97;6;6;22;7;0;4;0;1;16;17;0;9;152;12;29
15.02.2023 23:00;49;73;7;5;6;5;0;3;0;4;15;5;4;1;122;12;11
16.02.2023 00:00;8;15;2;0;4;0;1;0;0;1;1;2;0;0;23;2;4
16.02.2023 01:00;3;13;1;0;0;1;0;0;0;0;1;2;0;0;16;1;1
16.02.2023 02:00;4;4;1;0;3;0;0;0;0;0;0;0;0;0;8;1;3
16.02.2023 03:00;1;8;0;1;1;0;0;0;0;2;2;0;0;0;9;1;1
16.02.2023 04:00;1;9;0;2;5;2;0;0;0;0;4;1;1;0;10;2;7
16.02.2023 05:00;31;22;8;2;7;7;1;3;0;0;13;7;2;4;53;10;14
16.02.2023 06:00;72;71;19;15;38;20;12;25;0;14;37;32;14;22;143;34;58
16.02.2023 07:00;257;225;52;39;105;98;29;79;0;27;82;153;50;71;482;91;203
16.02.2023 08:00;265;274;59;32;176;145;16;108;0;35;70;253;39;109;539;91;321
16.02.2023 09:00;155;228;25;15;68;65;8;49;0;22;34;127;36;58;383;40;133
16.02.2023 10:00;112;255;22;8;52;42;8;37;0;45;44;88;17;59;367;30;94
16.02.2023 11:00;127;222;21;13;63;50;20;32;0;27;46;59;30;65;349;34;113
16.02.2023 12:00;213;284;39;20;73;59;30;50;0;58;51;120;34;76;497;59;132
16.02.2023 13:00;164;215;45;22;69;61;13;48;0;30;36;110;26;51;379;67;130
16.02.2023 14:00;163;194;33;27;67;48;18;54;0;27;36;99;23;50;357;60;115
16.02.2023 15:00;135;184;33;35;84;49;11;79;0;19;50;106;33;64;319;68;133
16.02.2023 16:00;145;244;52;28;101;69;26;74;0;34;60;155;37;86;389;80;170
16.02.2023 17:00;161;232;59;24;105;83;29;72;0;39;48;178;68;99;393;83;188
16.02.2023 18:00;128;185;38;20;94;50;17;67;0;19;50;115;42;57;313;58;144
16.02.2023 19:00;111;156;22;9;41;27;5;19;0;17;17;64;8;29;267;31;68
16.02.2023 20:00;66;117;10;2;23;18;1;18;0;4;17;31;11;19;183;12;41
16.02.2023 21:00;54;102;11;3;18;12;2;8;0;3;14;18;5;14;156;14;30
16.02.2023 22:00;52;83;5;2;18;3;1;4;0;2;10;16;1;7;135;7;21
16.02.2023 23:00;20;44;3;3;7;2;0;4;0;3;8;7;2;2;64;6;9
17.02.2023 00:00;9;24;2;1;3;1;0;0;0;1;5;3;0;2;33;3;4
17.02.2023 01:00;7;19;1;1;1;0;0;0;0;0;4;0;0;2;26;2;1
17.02.2023 02:00;3;11;1;0;1;0;0;1;0;0;1;1;0;0;14;1;1
17.02.2023 03:00;4;5;0;0;2;1;0;1;0;0;0;1;1;0;9;0;3
17.02.2023 04:00;2;8;2;0;4;1;0;1;0;0;9;3;1;1;10;2;5
17.02.2023 05:00;32;28;11;4;10;2;2;5;0;0;6;6;1;3;60;15;12
17.02.2023 06:00;71;70;21;14;23;17;5;21;0;4;32;22;17;16;141;35;40
17.02.2023 07:00;132;143;41;28;72;57;21;40;0;13;45;78;27;45;275;69;129
17.02.2023 08:00;170;195;25;17;73;99;13;46;0;22;49;132;22;58;365;42;172
17.02.2023 09:00;139;134;19;10;58;49;5;44;0;23;40;89;21;53;273;29;107
17.02.2023 10:00;107;167;15;16;33;21;10;38;0;28;24;66;38;49;274;31;54
17.02.2023 11:00;103;221;28;18;45;32;25;49;0;36;35;89;41;77;324;46;77
17.02.2023 12:00;142;223;45;20;54;47;21;87;0;35;55;102;51;101;365;65;101
17.02.2023 13:00;159;285;35;26;71;51;20;87;0;40;62;101;57;82;444;61;122
17.02.2023 14:00;181;309;58;38;105;72;22;85;0;33;75;139;70;104;490;96;177
17.02.2023 15:00;180;346;43;29;115;86;35;132;0;41;52;187;106;110;526;72;201
17.02.2023 16:00;173;346;57;26;105;76;37;116;0;47;64;171;88;117;519;83;181
17.02.2023 17:00;125;334;46;30;84;72;37;99;0;43;51;143;65;115;459;76;156
17.02.2023 18:00;110;268;18;7;58;45;10;47;0;20;39;80;28;41;378;25;103
17.02.2023 19:00;136;201;14;2;33;15;5;19;0;11;29;35;15;23;337;16;48
17.02.2023 20:00;82;110;11;2;15;16;0;12;0;9;23;24;5;18;192;13;31
17.02.2023 21:00;39;96;5;2;11;9;1;13;0;7;7;17;3;9;135;7;20
17.02.2023 22:00;36;75;8;3;10;5;1;10;0;6;15;18;2;13;111;11;15
17.02.2023 23:00;33;68;4;4;9;4;0;3;0;12;10;12;2;8;101;8;13
18.02.2023 00:00;12;50;0;0;4;6;0;1;0;2;6;2;2;4;62;0;10
18.02.2023 01:00;11;44;1;1;2;3;0;1;0;1;4;3;0;2;55;2;5
18.02.2023 02:00;11;32;0;1;0;1;0;0;0;0;0;3;0;5;43;1;1
18.02.2023 03:00;6;12;0;0;1;2;0;0;0;1;0;2;0;1;18;0;3
18.02.2023 04:00;9;7;0;1;2;1;0;1;0;4;5;1;1;0;16;1;3
18.02.2023 05:00;4;8;3;1;4;4;1;2;0;0;4;4;0;1;12;4;8
18.02.2023 06:00;10;12;2;1;2;5;1;2;0;0;6;4;3;4;22;3;7
18.02.2023 07:00;13;15;9;5;8;2;7;4;0;4;11;5;3;2;28;14;10
18.02.2023 08:00;30;40;7;6;29;20;5;16;0;7;22;30;21;16;70;13;49
18.02.2023 09:00;72;93;13;6;22;17;6;25;0;25;21;41;31;36;165;19;39
18.02.2023 10:00;71;140;20;10;23;18;14;40;0;11;24;62;43;55;211;30;41
18.02.2023 11:00;105;156;31;13;29;19;11;32;0;17;28;48;16;39;261;44;48
18.02.2023 12:00;113;153;20;9;35;13;11;51;0;13;32;50;25;74;266;29;48
18.02.2023 13:00;81;122;23;10;26;17;12;26;0;10;29;41;27;40;203;33;43
18.02.2023 14:00;92;161;21;12;39;34;8;19;0;16;41;51;10;40;253;33;73
18.02.2023 15:00;70;123;13;8;31;23;12;41;0;18;28;43;24;50;193;21;54
18.02.2023 16:00;58;131;20;12;29;18;7;36;0;15;30;51;24;35;189;32;47
18.02.2023 17:00;88;150;24;5;48;27;9;44;0;19;21;48;22;59;238;29;75
18.02.2023 18:00;94;145;14;6;23;22;11;22;0;7;31;29;11;39;239;20;45
18.02.2023 19:00;59;123;14;1;15;5;5;5;0;9;26;20;3;26;182;15;20
18.02.2023 20:00;57;90;8;3;20;6;0;6;0;4;16;14;3;22;147;11;26
18.02.2023 21:00;41;57;5;3;13;7;0;4;0;5;15;10;2;13;98;8;20
18.02.2023 22:00;22;43;7;0;3;3;0;0;0;1;11;6;0;6;65;7;6
18.02.2023 23:00;18;36;3;3;4;2;1;1;0;4;9;6;1;4;54;6;6
19.02.2023 00:00;31;42;0;0;12;3;0;1;0;5;5;4;0;5;73;0;15
19.02.2023 01:00;17;39;2;0;3;3;0;2;0;3;4;3;0;20;56;2;6
19.02.2023 02:00;15;19;4;0;5;2;0;1;0;1;0;2;0;3;34;4;7
19.02.2023 03:00;13;20;0;0;2;3;0;1;0;1;6;0;1;15;33;0;5
19.02.2023 04:00;1;10;0;0;0;0;0;0;0;0;7;2;0;0;11;0;0
19.02.2023 05:00;6;4;0;1;3;0;0;0;0;0;4;2;0;1;10;1;3
19.02.2023 06:00;4;7;1;1;1;1;2;1;0;5;3;1;1;2;11;2;2
19.02.2023 07:00;9;12;2;9;7;4;0;3;0;7;6;8;3;7;21;11;11
19.02.2023 08:00;19;19;5;3;8;10;1;6;0;4;11;9;9;15;38;8;18
19.02.2023 09:00;26;34;7;3;18;12;1;18;0;5;10;15;16;15;60;10;30
19.02.2023 10:00;56;101;13;7;17;30;3;27;0;4;31;41;23;37;157;20;47
19.02.2023 11:00;32;67;35;15;30;21;10;37;0;11;25;39;20;40;99;50;51
19.02.2023 12:00;60;127;16;18;37;32;11;52;0;18;23;61;28;50;187;34;69
19.02.2023 13:00;82;139;31;22;41;46;20;42;0;20;23;49;31;72;221;53;87
19.02.2023 14:00;74;122;44;14;37;35;15;43;0;16;17;83;35;55;196;58;72
19.02.2023 15:00;99;105;29;10;27;47;12;53;0;24;16;77;42;87;204;39;74
19.02.2023 16:00;97;104;39;17;35;52;18;49;0;21;21;82;36;68;201;56;87
19.02.2023 17:00;104;138;26;11;54;41;15;54;0;19;27;74;38;72;242;37;95
19.02.2023 18:00;84;103;12;13;29;14;8;42;0;13;29;47;38;37;187;25;43
19.02.2023 19:00;51;75;6;4;31;15;2;6;0;7;15;16;3;16;126;10;46
19.02.2023 20:00;55;56;5;0;11;5;3;6;0;2;4;14;6;6;111;5;16
19.02.2023 21:00;34;65;8;3;7;6;0;4;0;0;6;16;3;12;99;11;13
19.02.2023 22:00;23;39;4;0;3;3;1;3;0;3;7;5;1;5;62;4;6
19.02.2023 23:00;20;36;2;4;4;3;0;2;0;1;4;1;1;5;56;6;7
20.02.2023 00:00;10;20;0;1;1;1;0;0;0;1;1;0;0;5;30;1;2
20.02.2023 01:00;5;9;0;0;1;0;0;0;0;0;3;3;1;4;14;0;1
20.02.2023 02:00;3;11;0;0;0;0;0;1;0;0;3;0;0;1;14;0;0
20.02.2023 03:00;2;5;0;0;2;1;0;0;0;1;2;0;0;1;7;0;3
20.02.2023 04:00;1;7;2;1;2;1;0;0;0;0;6;2;1;1;8;3;3
20.02.2023 05:00;13;20;4;1;7;5;1;2;0;1;7;4;2;1;33;5;12
20.02.2023 06:00;21;22;7;6;16;4;1;6;0;2;8;6;9;5;43;13;20
20.02.2023 07:00;56;71;24;10;18;22;6;12;0;10;19;39;7;25;127;34;40
20.02.2023 08:00;52;62;18;5;40;47;6;22;0;8;26;72;15;37;114;23;87
20.02.2023 09:00;65;76;26;10;29;32;6;42;0;22;20;55;28;47;141;36;61
20.02.2023 10:00;102;106;46;14;50;44;23;51;0;30;30;63;49;82;208;60;94
20.02.2023 11:00;231;158;59;28;62;45;36;125;0;51;52;123;85;134;389;87;107
20.02.2023 12:00;382;190;75;48;75;64;46;152;0;44;50;196;102;164;572;123;139
20.02.2023 13:00;334;209;80;44;91;84;57;176;0;62;49;216;139;188;543;124;175
20.02.2023 14:00;216;231;67;47;100;86;46;181;0;54;50;193;159;228;447;114;186
20.02.2023 15:00;161;297;86;42;124;114;70;155;0;41;46;199;114;251;458;128;238
20.02.2023 16:00;203;378;77;45;113;94;43;133;0;52;72;195;105;235;581;122;207
20.02.2023 17:00;206;286;77;44;94;116;33;119;0;69;76;174;82;235;492;121;210
20.02.2023 18:00;138;214;44;19;34;40;18;50;0;14;37;96;35;62;352;63;74
20.02.2023 19:00;63;137;12;12;26;16;11;22;0;12;15;39;10;20;200;24;42
20.02.2023 20:00;63;108;6;4;16;11;0;5;0;5;16;19;6;18;171;10;27
20.02.2023 21:00;45;86;5;2;12;6;2;6;0;5;12;10;7;7;131;7;18
20.02.2023 22:00;27;74;4;2;5;5;0;3;0;3;16;14;2;8;101;6;10
20.02.2023 23:00;24;28;5;3;5;3;1;3;0;1;4;3;0;4;52;8;8
21.02.2023 00:00;4;21;1;4;2;3;0;1;0;2;6;5;0;5;25;5;5
21.02.2023 01:00;8;14;0;0;2;1;0;0;0;1;5;2;0;6;22;0;3
21.02.2023 02:00;6;5;0;0;0;1;0;0;0;1;2;0;0;2;11;0;1
21.02.2023 03:00;1;2;0;0;1;1;0;0;0;0;2;0;0;1;3;0;2
21.02.2023 04:00;5;8;2;1;7;1;0;0;0;1;7;2;2;0;13;3;8
21.02.2023 05:00;43;36;14;7;16;8;2;6;0;1;18;9;3;10;79;21;24
21.02.2023 06:00;117;103;32;36;49;33;11;22;0;4;40;45;17;28;220;68;82
21.02.2023 07:00;277;227;60;38;132;104;34;83;0;35;76;167;46;98;504;98;236
21.02.2023 08:00;348;313;66;26;211;169;26;116;0;46;82;319;63;118;661;92;380
21.02.2023 09:00;175;190;38;11;81;67;25;59;0;30;49;124;23;76;365;49;148
21.02.2023 10:00;142;169;22;19;45;33;6;44;0;22;28;74;44;92;311;41;78
21.02.2023 11:00;130;197;26;16;49;54;34;64;0;23;32;104;40;82;327;42;103
21.02.2023 12:00;181;245;35;20;62;51;25;99;0;36;48;112;62;98;426;55;113
21.02.2023 13:00;142;282;35;27;82;70;23;113;0;41;47;119;78;109;424;62;152
21.02.2023 14:00;202;350;75;36;112;94;46;123;0;49;51;177;107;170;552;111;206
21.02.2023 15:00;252;417;94;35;138;131;49;159;0;73;68;203;105;229;669;129;269
21.02.2023 16:00;275;499;125;59;187;172;60;146;0;79;101;276;100;273;774;184;359
21.02.2023 17:00;286;490;95;55;224;169;52;145;0;90;87;313;111;279;776;150;393
21.02.2023 18:00;225;373;69;34;140;91;44;89;0;46;77;182;59;134;598;103;231
21.02.2023 19:00;115;255;23;18;59;39;9;39;0;18;31;77;18;46;370;41;98
21.02.2023 20:00;63;145;15;7;28;23;5;13;0;4;16;32;12;23;208;22;51
21.02.2023 21:00;56;93;6;8;22;7;3;10;0;4;15;11;11;10;149;14;29
21.02.2023 22:00;46;69;14;0;16;6;0;12;0;3;17;15;0;9;115;14;22
21.02.2023 23:00;14;29;3;3;9;1;0;4;0;1;9;2;0;3;43;6;10
22.02.2023 00:00;6;7;0;0;0;1;0;1;0;1;1;1;0;4;13;0;1
22.02.2023 01:00;2;8;0;0;0;0;0;0;0;0;1;0;0;0;10;0;0
22.02.2023 02:00;3;2;0;0;2;0;0;0;0;0;0;0;0;0;5;0;2
22.02.2023 03:00;0;3;0;0;2;2;0;0;0;0;0;2;0;0;3;0;4
22.02.2023 04:00;5;6;1;0;9;0;0;1;0;2;9;2;1;3;11;1;9
22.02.2023 05:00;33;43;13;7;18;9;2;5;0;3;14;9;2;8;76;20;27
22.02.2023 06:00;112;120;32;43;65;36;21;29;0;9;50;54;21;30;232;75;101
22.02.2023 07:00;354;317;70;79;174;153;39;103;0;47;101;190;50;168;671;149;327
22.02.2023 08:00;399;376;69;29;226;208;36;120;0;45;100;377;62;150;775;98;434
22.02.2023 09:00;176;228;25;13;75;71;15;57;0;27;50;133;23;76;404;38;146
22.02.2023 10:00;139;214;17;15;50;43;14;42;0;27;53;75;35;77;353;32;93
22.02.2023 11:00;148;231;23;27;45;50;24;50;0;27;51;101;45;91;379;50;95
22.02.2023 12:00;140;266;41;20;65;40;24;78;0;25;64;122;52;99;406;61;105
22.02.2023 13:00;184;341;44;29;82;82;39;80;0;54;61;148;57;140;525;73;164
22.02.2023 14:00;171;331;58;39;118;90;52;108;0;60;73;174;78;167;502;97;208
22.02.2023 15:00;248;384;77;39;132;109;39;100;0;61;71;202;79;182;632;116;241
22.02.2023 16:00;258;484;106;60;187;140;68;127;0;69;99;257;86;209;742;166;327
22.02.2023 17:00;257;595;88;51;207;167;38;155;0;66;110;307;82;198;852;139;374
22.02.2023 18:00;202;415;53;32;128;114;23;75;0;44;54;198;54;124;617;85;242
22.02.2023 19:00;168;274;26;16;73;36;3;34;0;27;44;85;16;77;442;42;109
22.02.2023 20:00;95;165;10;13;37;22;1;20;0;10;24;37;12;24;260;23;59
22.02.2023 21:00;86;160;8;3;18;15;0;15;0;3;24;21;9;25;246;11;33
22.02.2023 22:00;57;85;9;4;13;12;1;4;0;4;18;18;2;4;142;13;25
22.02.2023 23:00;25;50;6;3;5;2;2;1;0;2;9;3;2;7;75;9;7
23.02.2023 00:00;5;17;0;0;1;0;0;1;0;0;2;1;0;0;22;0;1
23.02.2023 01:00;0;4;0;0;3;1;0;0;0;1;0;1;0;0;4;0;4
23.02.2023 02:00;1;5;0;0;0;0;0;0;0;0;0;0;0;0;6;0;0
23.02.2023 03:00;1;1;0;0;2;0;0;0;0;0;2;0;0;0;2;0;2
23.02.2023 04:00;2;6;1;0;5;2;1;1;0;0;5;2;1;3;8;1;7
23.02.2023 05:00;22;31;9;5;15;8;0;4;0;0;11;10;1;4;53;14;23
23.02.2023 06:00;86;99;19;22;38;31;11;27;0;4;40;35;20;22;185;41;69
23.02.2023 07:00;305;297;57;53;119;124;20;94;0;46;75;169;43;155;602;110;243
23.02.2023 08:00;335;362;62;27;185;181;30;106;0;34;108;282;54;135;697;89;366
23.02.2023 09:00;172;252;18;17;83;59;11;66;0;26;52;141;28;67;424;35;142
23.02.2023 10:00;133;154;10;17;37;35;13;36;0;24;39;63;33;57;287;27;72
23.02.2023 11:00;117;146;14;10;23;41;9;46;0;26;43;64;33;48;263;24;64
23.02.2023 12:00;119;189;22;8;45;41;11;42;0;29;38;65;29;68;308;30;86
23.02.2023 13:00;116;274;23;10;61;55;12;49;0;29;53;88;30;79;390;33;116
23.02.2023 14:00;137;268;39;17;68;42;21;56;0;18;52;70;38;54;405;56;110
23.02.2023 15:00;170;342;42;19;69;73;12;57;0;40;62;124;27;78;512;61;142
23.02.2023 16:00;198;422;60;37;141;97;26;81;0;35;103;141;37;122;620;97;238
23.02.2023 17:00;234;419;73;30;144;110;32;83;0;41;81;196;41;118;653;103;254
23.02.2023 18:00;167;359;39;16;119;76;18;74;0;39;72;155;46;88;526;55;195
23.02.2023 19:00;126;266;13;6;46;34;6;28;0;14;38;73;11;54;392;19;80
23.02.2023 20:00;92;155;6;9;20;14;4;12;0;7;19;43;8;19;247;15;34
23.02.2023 21:00;54;112;8;1;13;10;1;4;0;7;25;17;2;19;166;9;23
23.02.2023 22:00;58;87;5;2;16;7;1;3;0;3;24;13;2;8;145;7;23
23.02.2023 23:00;18;34;4;2;7;4;0;1;0;4;5;10;2;3;52;6;11
24.02.2023 00:00;4;19;0;0;2;1;0;1;0;2;2;3;0;2;23;0;3
24.02.2023 01:00;5;7;0;0;2;0;0;0;0;0;1;0;0;2;12;0;2
24.02.2023 02:00;3;4;0;0;1;0;0;0;0;0;2;1;0;1;7;0;1
24.02.2023 03:00;1;2;0;0;2;0;0;0;0;0;3;0;0;0;3;0;2
24.02.2023 04:00;4;7;2;0;4;0;1;0;0;6;12;3;2;3;11;2;4
24.02.2023 05:00;30;26;9;5;12;4;2;3;0;0;10;9;0;2;56;14;16
24.02.2023 06:00;80;77;20;22;39;25;14;14;0;4;30;33;10;22;157;42;64
24.02.2023 07:00;266;249;60;46;94;82;20;62;0;32;70;113;43;110;515;106;176
24.02.2023 08:00;251;277;43;14;118;107;13;86;0;38;80;189;35;91;528;57;225
24.02.2023 09:00;161;196;28;13;54;50;16;53;0;20;50;101;25;56;357;41;104
24.02.2023 10:00;122;182;22;15;34;33;11;37;0;24;34;63;29;57;304;37;67
24.02.2023 11:00;121;183;30;10;39;26;9;37;0;23;46;66;31;69;304;40;65
24.02.2023 12:00;129;256;29;14;36;36;15;44;0;26;68;80;29;65;385;43;72
24.02.2023 13:00;163;315;32;19;65;48;12;41;0;39;68;70;32;67;478;51;113
24.02.2023 14:00;106;279;31;13;68;47;13;29;0;17;60;81;23;48;385;44;115
24.02.2023 15:00;140;239;39;19;56;44;14;40;0;26;61;75;19;53;379;58;100
24.02.2023 16:00;131;248;37;16;69;41;11;50;0;16;52;87;26;43;379;53;110
24.02.2023 17:00;126;255;32;11;62;44;11;26;0;23;46;87;24;63;381;43;106
24.02.2023 18:00;114;251;24;6;52;27;10;26;0;9;38;76;18;34;365;30;79
24.02.2023 19:00;102;175;14;5;24;20;1;15;0;10;41;36;7;22;277;19;44
24.02.2023 20:00;64;111;4;2;15;16;1;13;0;9;19;20;6;22;175;6;31
24.02.2023 21:00;42;76;1;2;15;4;0;3;0;5;8;14;4;12;118;3;19
24.02.2023 22:00;51;49;5;2;6;5;0;4;0;1;9;6;1;5;100;7;11
24.02.2023 23:00;35;30;1;1;5;4;0;2;0;3;7;11;0;6;65;2;9
25.02.2023 00:00;24;26;5;0;5;3;0;1;0;3;6;3;1;3;50;5;8
25.02.2023 01:00;7;15;0;0;6;0;0;4;0;0;3;3;0;1;22;0;6
25.02.2023 02:00;5;11;2;0;1;1;0;0;0;0;0;2;0;4;16;2;2
25.02.2023 03:00;2;8;0;0;1;0;0;0;0;1;0;0;0;0;10;0;1
25.02.2023 04:00;1;6;0;0;1;0;0;0;0;0;3;0;1;0;7;0;1
25.02.2023 05:00;8;9;1;0;3;5;1;2;0;1;6;3;2;1;17;1;8
25.02.2023 06:00;8;14;3;1;1;1;1;2;0;0;5;2;0;2;22;4;2
25.02.2023 07:00;19;18;9;5;6;6;3;3;0;4;10;10;3;7;37;14;12
25.02.2023 08:00;27;51;15;8;16;12;7;7;0;12;24;22;11;20;78;23;28
25.02.2023 09:00;90;116;18;9;24;14;2;24;0;16;31;39;16;36;206;27;38
25.02.2023 10:00;85;147;17;7;18;17;8;20;0;16;24;45;24;37;232;24;35
25.02.2023 11:00;85;157;18;11;24;18;8;20;0;25;31;41;14;43;242;29;42
25.02.2023 12:00;81;175;13;8;20;18;17;29;0;23;31;55;20;54;256;21;38
25.02.2023 13:00;123;175;27;11;30;21;15;25;0;25;28;59;26;67;298;38;51
25.02.2023 14:00;116;250;26;16;40;35;17;50;0;25;46;59;25;86;366;42;75
25.02.2023 15:00;121;217;18;8;38;35;19;55;0;16;25;69;37;97;338;26;73
25.02.2023 16:00;111;213;29;27;49;35;22;66;0;15;39;93;48;129;324;56;84
25.02.2023 17:00;126;197;34;12;39;62;11;65;0;33;21;74;43;100;323;46;101
25.02.2023 18:00;107;169;25;13;33;37;12;30;0;17;30;65;37;46;276;38;70
25.02.2023 19:00;75;160;14;2;8;8;3;10;0;5;17;14;5;16;235;16;16
25.02.2023 20:00;59;97;3;2;20;4;1;7;0;2;6;12;3;11;156;5;24
25.02.2023 21:00;52;65;3;5;7;7;0;1;0;9;9;12;4;11;117;8;14
25.02.2023 22:00;31;75;3;1;10;4;1;1;0;0;17;13;1;6;106;4;14
25.02.2023 23:00;32;42;0;2;8;3;0;2;0;0;6;1;2;8;74;2;11
26.02.2023 00:00;17;45;3;1;8;3;0;5;0;2;7;4;2;1;62;4;11
26.02.2023 01:00;7;28;1;0;2;4;0;0;0;3;3;11;0;6;35;1;6
26.02.2023 02:00;3;14;3;0;1;1;0;0;0;0;3;1;0;0;17;3;2
26.02.2023 03:00;1;2;0;0;1;0;0;0;0;0;1;1;0;0;3;0;1
26.02.2023 04:00;3;3;1;0;2;0;0;0;0;0;1;0;0;1;6;1;2
26.02.2023 05:00;5;5;0;2;3;3;0;1;0;0;3;1;0;1;10;2;6
26.02.2023 06:00;4;5;1;0;3;0;1;1;0;0;3;1;1;2;9;1;3
26.02.2023 07:00;7;11;5;1;2;1;3;4;0;2;4;5;5;3;18;6;3
26.02.2023 08:00;13;32;13;3;16;9;6;15;0;2;10;4;16;16;45;16;25
26.02.2023 09:00;44;59;19;7;39;16;12;34;0;15;19;39;23;40;103;26;55
26.02.2023 10:00;93;105;39;14;50;53;10;80;0;21;23;71;50;84;198;53;103
26.02.2023 11:00;69;121;48;25;60;53;32;72;0;28;29;91;62;81;190;73;113
26.02.2023 12:00;101;154;58;25;43;52;33;82;0;40;25;85;63;113;255;83;95
26.02.2023 13:00;111;189;57;25;65;57;36;77;0;42;29;135;72;120;300;82;122
26.02.2023 14:00;118;213;49;29;84;57;41;88;0;42;32;118;56;138;331;78;141
26.02.2023 15:00;97;164;50;27;69;66;37;69;0;36;33;106;49;100;261;77;135
26.02.2023 16:00;106;198;36;30;60;63;22;76;0;38;21;123;64;135;304;66;123
26.02.2023 17:00;132;206;42;17;41;60;22;52;0;25;21;99;49;122;338;59;101
26.02.2023 18:00;86;130;10;17;28;27;8;28;0;14;21;40;28;43;216;27;55
26.02.2023 19:00;71;92;6;5;17;9;2;9;0;11;15;25;6;8;163;11;26
26.02.2023 20:00;43;59;7;5;14;4;1;6;0;3;8;10;8;8;102;12;18
26.02.2023 21:00;39;59;5;1;8;2;0;6;0;1;18;10;4;5;98;6;10
26.02.2023 22:00;23;37;3;0;5;1;0;1;0;0;7;5;0;4;60;3;6
26.02.2023 23:00;5;20;1;0;0;2;0;0;0;3;3;0;0;1;25;1;2
27.02.2023 00:00;5;3;0;0;0;0;0;1;0;0;0;0;2;0;8;0;0
27.02.2023 01:00;2;3;0;0;2;0;0;0;0;0;0;0;0;0;5;0;2
27.02.2023 02:00;1;2;0;0;0;0;0;0;0;0;0;0;0;0;3;0;0
27.02.2023 03:00;0;4;0;0;2;0;0;0;0;1;0;0;0;0;4;0;2
27.02.2023 04:00;5;10;2;1;4;0;1;0;0;2;4;3;2;1;15;3;4
27.02.2023 05:00;34;52;16;6;16;6;4;7;0;2;15;11;4;10;86;22;22
27.02.2023 06:00;126;127;29;27;59;43;11;22;0;11;52;49;18;46;253;56;102
27.02.2023 07:00;438;411;66;68;154;137;52;80;0;52;102;204;47;166;849;134;291
27.02.2023 08:00;389;410;58;36;177;159;27;138;0;42;104;321;44;155;799;94;336
27.02.2023 09:00;232;250;35;14;81;73;15;61;0;22;57;177;26;72;482;49;154
27.02.2023 10:00;149;195;19;13;43;38;12;26;0;21;51;60;27;59;344;32;81
27.02.2023 11:00;121;221;18;15;44;34;10;34;0;20;45;86;27;78;342;33;78
27.02.2023 12:00;173;290;44;16;62;52;21;58;0;42;59;108;34;85;463;60;114
27.02.2023 13:00;162;388;72;19;83;75;26;69;0;30;68;124;32;136;550;91;158
27.02.2023 14:00;192;358;49;21;79;61;20;49;0;37;74;145;46;161;550;70;140
27.02.2023 15:00;226;425;72;22;130;111;32;90;0;50;105;175;53;165;651;94;241
27.02.2023 16:00;300;552;84;32;153;111;30;110;0;48;122;214;53;156;852;116;264
27.02.2023 17:00;250;555;83;42;197;129;37;102;0;61;124;263;54;174;805;125;326
27.02.2023 18:00;212;437;39;24;112;82;23;63;0;32;93;193;38;92;649;63;194
27.02.2023 19:00;160;326;16;9;52;38;8;37;0;26;50;68;13;72;486;25;90
27.02.2023 20:00;78;177;12;6;34;17;1;8;0;10;36;32;10;14;255;18;51
27.02.2023 21:00;77;121;7;4;18;13;3;4;0;4;26;20;2;17;198;11;31
27.02.2023 22:00;46;77;4;1;21;6;1;2;0;7;24;5;2;6;123;5;27
27.02.2023 23:00;17;41;1;4;8;4;0;1;0;4;13;3;0;6;58;5;12
28.02.2023 00:00;3;14;2;0;1;1;0;0;0;0;3;5;0;1;17;2;2
28.02.2023 01:00;3;6;0;0;1;0;0;0;0;1;2;0;0;0;9;0;1
28.02.2023 02:00;3;4;0;0;1;0;0;0;0;0;1;0;0;0;7;0;1
28.02.2023 03:00;2;2;3;0;2;0;0;0;0;0;2;0;0;0;4;3;2
28.02.2023 04:00;5;12;1;0;4;0;0;0;0;0;2;3;1;0;17;1;4
28.02.2023 05:00;35;33;9;11;15;6;3;5;0;1;13;10;2;6;68;20;21
28.02.2023 06:00;101;94;34;24;57;33;12;16;0;11;41;42;16;30;195;58;90
28.02.2023 07:00;337;302;71;58;149;152;28;87;0;50;98;199;46;127;639;129;301
28.02.2023 08:00;364;342;61;31;210;176;35;142;0;42;80;336;53;158;706;92;386
28.02.2023 09:00;196;219;28;17;81;73;8;64;0;17;63;138;33;68;415;45;154
28.02.2023 10:00;125;160;16;7;32;42;8;47;0;27;37;70;31;55;285;23;74
28.02.2023 11:00;122;181;21;10;55;37;12;33;0;20;37;59;29;67;303;31;92
28.02.2023 12:00;150;239;41;24;55;46;20;46;0;31;38;92;27;96;389;65;101
28.02.2023 13:00;137;335;34;19;79;48;20;74;0;40;48;107;34;111;472;53;127
28.02.2023 14:00;175;326;41;37;81;74;23;81;0;39;57;132;52;122;501;78;155
28.02.2023 15:00;208;371;62;31;107;103;35;97;0;40;59;162;46;145;579;93;210
28.02.2023 16:00;263;464;69;43;151;109;31;98;0;59;99;183;57;189;727;112;260
28.02.2023 17:00;245;495;80;41;173;135;35;126;0;72;87;258;63;223;740;121;308
28.02.2023 18:00;201;389;67;37;117;89;16;60;0;51;69;194;52;127;590;104;206
28.02.2023 19:00;132;284;11;8;59;44;7;31;0;21;40;63;19;55;416;19;103
28.02.2023 20:00;85;169;11;2;22;14;1;17;0;14;36;29;8;26;254;13;36
28.02.2023 21:00;72;117;11;0;18;8;2;8;0;7;24;24;7;16;189;11;26
28.02.2023 22:00;40;73;3;3;15;3;1;8;0;4;17;4;3;8;113;6;18
28.02.2023 23:00;17;30;2;6;11;3;1;0;0;3;10;3;3;5;47;8;14
01.03.2023 00:00;5;10;4;0;2;1;0;1;0;1;5;3;1;3;15;4;3
01.03.2023 01:00;1;8;1;0;0;0;0;0;0;0;3;0;0;0;9;1;0
01.03.2023 02:00;1;2;0;1;0;0;0;0;0;0;1;1;0;0;3;1;0
01.03.2023 03:00;2;2;0;0;2;0;1;1;0;1;2;0;0;1;4;0;2
01.03.2023 04:00;4;8;2;0;4;1;1;0;0;0;1;1;1;0;12;2;5
01.03.2023 05:00;33;25;10;4;21;10;1;3;0;4;14;9;2;3;58;14;31
01.03.2023 06:00;115;100;22;19;57;27;13;23;0;8;47;40;17;25;215;41;84
01.03.2023 07:00;328;292;81;49;128;139;36;89;0;46;109;185;55;148;620;130;267
01.03.2023 08:00;391;324;61;24;185;153;33;140;0;41;78;337;47;142;715;85;338
01.03.2023 09:00;173;222;25;10;66;74;12;58;0;20;44;134;34;53;395;35;140
01.03.2023 10:00;123;157;18;7;28;32;5;28;0;15;25;57;21;47;280;25;60
01.03.2023 11:00;104;171;24;12;34;45;16;33;0;18;39;74;32;86;275;36;79
01.03.2023 12:00;130;255;28;28;40;30;21;63;0;30;57;93;30;85;385;56;70
01.03.2023 13:00;156;331;43;19;73;84;27;72;0;48;55;132;38;119;487;62;157
01.03.2023 14:00;162;341;48;36;91;70;33;71;0;39;65;129;56;139;503;84;161
01.03.2023 15:00;185;362;63;30;97;110;31;112;0;50;83;151;66;152;547;93;207
01.03.2023 16:00;245;439;89;53;140;133;49;108;0;61;94;233;76;226;684;142;273
01.03.2023 17:00;238;529;88;42;193;142;28;135;0;61;94;275;71;258;767;130;335
01.03.2023 18:00;234;428;47;32;113;101;30;81;0;55;52;215;39;135;662;79;214
01.03.2023 19:00;149;279;23;14;64;39;6;33;0;22;51;82;16;55;428;37;103
01.03.2023 20:00;105;149;11;7;36;18;2;12;0;13;25;23;17;25;254;18;54
01.03.2023 21:00;84;113;10;2;20;10;1;6;0;6;23;15;2;22;197;12;30
01.03.2023 22:00;60;115;8;3;20;8;2;4;0;7;15;18;3;14;175;11;28
01.03.2023 23:00;22;40;1;0;2;6;0;3;0;1;9;5;2;2;62;1;8
02.03.2023 00:00;15;23;1;0;3;0;0;0;0;2;4;1;0;3;38;1;3
02.03.2023 01:00;2;1;1;0;0;0;0;0;0;0;0;1;0;0;3;1;0
02.03.2023 02:00;2;2;0;0;1;0;0;0;0;0;1;0;0;0;4;0;1
02.03.2023 03:00;2;2;0;0;2;0;0;0;0;0;3;0;0;0;4;0;2
02.03.2023 04:00;4;4;0;1;5;1;0;0;0;0;2;1;1;0;8;1;6
02.03.2023 05:00;28;29;6;10;19;6;1;6;0;2;13;11;4;5;57;16;25
02.03.2023 06:00;100;76;20;19;57;28;12;27;0;5;49;42;17;23;176;39;85
02.03.2023 07:00;342;321;75;41;123;146;34;99;0;40;98;164;48;154;663;116;269
02.03.2023 08:00;328;333;61;34;182;185;30;136;0;43;87;311;44;149;661;95;367
02.03.2023 09:00;172;212;28;15;82;56;20;52;0;19;58;141;24;64;384;43;138
02.03.2023 10:00;131;163;26;10;29;42;5;40;0;20;46;88;19;62;294;36;71
02.03.2023 11:00;118;173;32;23;47;45;17;74;109;24;53;88;51;73;291;55;92
02.03.2023 12:00;155;263;41;26;51;58;24;71;78;29;63;92;52;98;418;67;109
02.03.2023 13:00;160;329;48;24;90;94;21;118;148;41;54;142;70;139;489;72;184
02.03.2023 14:00;168;321;58;33;107;80;45;95;170;37;60;140;80;162;489;91;187
02.03.2023 15:00;250;443;86;35;148;110;49;141;222;55;88;208;85;229;693;121;258
02.03.2023 16:00;274;510;92;64;176;157;57;129;217;64;105;234;85;231;784;156;333
02.03.2023 17:00;299;562;88;37;197;151;53;123;287;62;105;285;78;238;861;125;348
02.03.2023 18:00;221;469;59;33;127;103;35;97;140;38;64;225;67;141;690;92;230
02.03.2023 19:00;159;292;21;15;57;43;5;25;55;29;68;82;17;62;451;36;100
02.03.2023 20:00;107;167;16;4;34;19;3;13;28;8;22;27;8;31;274;20;53
02.03.2023 21:00;71;130;5;1;25;16;2;15;30;2;41;30;6;26;201;6;41
02.03.2023 22:00;74;127;3;2;21;9;2;4;12;6;19;13;4;13;201;5;30
02.03.2023 23:00;30;45;3;4;12;3;1;7;6;5;4;7;0;5;75;7;15
03.03.2023 00:00;9;18;1;1;6;5;0;0;9;1;4;2;1;5;27;2;11
03.03.2023 01:00;4;8;1;0;1;2;0;0;2;0;2;1;0;0;12;1;3
03.03.2023 02:00;2;5;0;0;0;0;0;0;3;1;0;1;0;1;7;0;0
03.03.2023 03:00;4;2;0;0;3;0;0;1;2;0;3;0;0;1;6;0;3
03.03.2023 04:00;9;13;1;0;5;0;0;0;1;0;7;2;1;0;22;1;5
03.03.2023 05:00;30;50;13;6;12;10;3;4;9;4;15;12;5;6;80;19;22
03.03.2023 06:00;103;99;15;20;54;27;11;20;35;5;51;43;24;32;202;35;81
03.03.2023 07:00;377;425;69;53;132;149;37;87;144;49;108;157;51;164;802;122;281
03.03.2023 08:00;356;362;48;36;148;112;26;105;105;34;105;236;37;105;718;84;260
03.03.2023 09:00;211;267;14;12;85;57;6;48;76;23;61;113;13;55;478;26;142
03.03.2023 10:00;167;222;19;4;37;40;9;23;44;11;51;58;22;47;389;23;77
03.03.2023 11:00;194;293;22;6;50;41;16;42;69;29;63;83;22;66;487;28;91
03.03.2023 12:00;205;371;33;22;80;39;19;39;72;17;73;99;18;80;576;55;119
03.03.2023 13:00;237;514;46;29;83;63;16;68;105;50;107;122;31;99;751;75;146
03.03.2023 14:00;214;503;53;18;96;76;30;70;101;37;98;116;35;129;717;71;172
03.03.2023 15:00;219;490;62;29;116;95;38;75;140;36;90;143;42;115;709;91;211
03.03.2023 16:00;202;468;62;35;130;91;34;104;181;51;99;183;73;173;670;97;221
03.03.2023 17:00;222;473;55;25;100;87;26;73;177;52;82;182;53;147;695;80;187
03.03.2023 18:00;218;388;42;24;64;49;20;43;99;25;50;107;30;96;606;66;113
03.03.2023 19:00;147;318;22;15;46;31;4;27;49;18;54;63;15;45;465;37;77
03.03.2023 20:00;128;166;13;5;36;15;6;13;30;14;31;21;3;32;294;18;51
03.03.2023 21:00;65;125;4;0;24;12;1;6;13;5;22;16;6;10;190;4;36
03.03.2023 22:00;64;128;7;1;12;11;3;4;22;12;24;18;1;11;192;8;23
03.03.2023 23:00;48;83;2;9;10;5;2;5;7;3;21;12;1;6;131;11;15
04.03.2023 00:00;27;60;2;0;6;3;1;4;8;3;16;8;0;6;87;2;9
04.03.2023 01:00;17;54;0;0;8;2;0;3;11;0;9;5;0;9;71;0;10
04.03.2023 02:00;8;32;1;0;1;1;0;0;3;1;0;1;0;1;40;1;2
04.03.2023 03:00;9;10;2;0;4;0;0;0;0;0;2;4;1;0;19;2;4
04.03.2023 04:00;5;9;1;1;1;2;0;3;0;0;4;0;0;0;14;2;3
04.03.2023 05:00;10;14;3;4;4;5;0;0;4;0;2;1;0;2;24;7;9
04.03.2023 06:00;16;19;1;0;6;1;1;4;6;1;6;8;4;4;35;1;7
04.03.2023 07:00;19;35;6;3;9;4;1;6;8;1;11;9;6;5;54;9;13
04.03.2023 08:00;42;75;15;7;18;17;7;12;21;9;21;24;12;26;117;22;35
04.03.2023 09:00;84;105;14;6;39;20;7;30;52;18;20;39;20;51;189;20;59
04.03.2023 10:00;95;201;26;17;33;15;13;36;56;17;23;46;33;62;296;43;48
04.03.2023 11:00;132;191;20;13;38;33;13;49;84;33;27;67;38;102;323;33;71
04.03.2023 12:00;144;258;37;24;48;34;22;51;73;32;50;69;44;78;402;61;82
04.03.2023 13:00;132;225;25;19;43;44;20;44;73;38;41;70;43;71;357;44;87
04.03.2023 14:00;109;204;31;13;50;49;27;44;73;28;38;84;40;88;313;44;99
04.03.2023 15:00;129;213;35;10;43;31;17;58;80;32;35;88;42;76;342;45;74
04.03.2023 16:00;97;197;34;11;49;45;26;55;98;19;39;80;29;78;294;45;94
04.03.2023 17:00;102;209;19;6;23;27;13;33;36;26;30;67;23;46;311;25;50
04.03.2023 18:00;87;155;12;12;26;21;11;27;40;10;26;43;19;35;242;24;47
04.03.2023 19:00;80;180;4;3;25;5;4;5;19;13;16;16;9;26;260;7;30
04.03.2023 20:00;68;90;7;0;12;9;0;4;14;3;13;30;3;12;158;7;21
04.03.2023 21:00;46;64;9;2;15;2;1;2;6;5;12;2;4;9;110;11;17
04.03.2023 22:00;43;64;3;2;8;8;1;2;6;1;3;5;4;8;107;5;16
04.03.2023 23:00;52;65;1;1;13;4;0;7;15;3;10;12;1;16;117;2;17
05.03.2023 00:00;27;55;0;1;8;3;0;1;4;6;8;4;0;3;82;1;11
05.03.2023 01:00;28;37;0;0;4;0;0;2;6;2;10;1;5;2;65;0;4
05.03.2023 02:00;16;28;0;0;2;0;0;0;2;2;3;4;0;2;44;0;2
05.03.2023 03:00;3;13;1;0;1;1;1;2;2;0;2;0;4;1;16;1;2
05.03.2023 04:00;1;8;2;1;1;1;0;5;0;0;4;7;0;0;9;3;2
05.03.2023 05:00;6;6;2;1;5;4;0;3;0;0;2;6;1;0;12;3;9
05.03.2023 06:00;7;11;0;1;2;1;0;0;3;2;5;5;2;2;18;1;3
05.03.2023 07:00;13;14;4;1;4;4;3;6;4;4;3;13;4;5;27;5;8
05.03.2023 08:00;19;32;13;1;17;11;5;11;27;3;9;23;13;25;51;14;28
05.03.2023 09:00;44;62;18;9;27;23;8;29;38;13;14;43;16;46;106;27;50
05.03.2023 10:00;91;112;31;15;39;52;15;38;83;23;14;78;39;72;203;46;91
05.03.2023 11:00;68;120;23;16;41;39;28;77;88;21;23;67;39;68;188;39;80
05.03.2023 12:00;75;148;29;17;50;35;17;38;63;21;20;70;31;65;223;46;85
05.03.2023 13:00;99;122;20;15;51;35;23;60;81;21;33;74;53;59;221;35;86
05.03.2023 14:00;101;153;33;15;42;54;16;74;67;22;32;93;50;55;254;48;96
05.03.2023 15:00;106;140;36;16;53;54;18;70;92;24;31;80;46;74;246;52;107
05.03.2023 16:00;90;111;38;19;44;42;24;42;75;18;31;88;42;57;201;57;86
05.03.2023 17:00;94;149;27;5;24;36;8;45;58;23;26;63;27;48;243;32;60
05.03.2023 18:00;88;141;13;13;22;19;15;34;37;15;14;34;24;37;229;26;41
05.03.2023 19:00;63;99;6;5;10;12;0;12;22;13;17;16;9;24;162;11;22
05.03.2023 20:00;54;80;5;2;22;2;0;6;10;4;14;9;2;14;134;7;24
05.03.2023 21:00;35;46;6;1;13;3;1;3;7;3;11;3;3;5;81;7;16
05.03.2023 22:00;31;38;2;5;1;2;0;0;2;5;9;5;2;5;69;7;3
05.03.2023 23:00;5;15;1;0;2;2;0;0;1;1;4;3;0;1;20;1;4
06.03.2023 00:00;2;6;0;1;2;0;0;0;2;0;4;1;0;0;8;1;2
06.03.2023 01:00;0;0;1;0;0;0;0;0;0;1;1;0;0;0;0;1;0
06.03.2023 02:00;3;4;0;0;0;0;0;0;0;0;0;1;0;0;7;0;0
06.03.2023 03:00;1;2;0;0;4;0;0;0;2;0;3;0;0;0;3;0;4
06.03.2023 04:00;3;6;2;1;3;0;0;0;2;0;4;2;1;1;9;3;3
06.03.2023 05:00;28;32;13;7;15;10;1;5;6;1;9;11;3;6;60;20;25
06.03.2023 06:00;94;85;23;24;44;31;19;21;29;9;42;35;22;29;179;47;75
06.03.2023 07:00;337;324;69;54;146;121;38;105;118;36;90;159;51;123;661;123;267
06.03.2023 08:00;321;341;55;33;172;154;14;116;151;37;98;276;37;135;662;88;326
06.03.2023 09:00;141;212;31;14;75;58;6;44;62;33;49;123;22;60;353;45;133
06.03.2023 10:00;113;145;17;6;36;42;9;33;44;14;38;50;25;39;258;23;78
06.03.2023 11:00;99;160;23;6;35;44;13;43;48;19;32;61;33;48;259;29;79
06.03.2023 12:00;113;201;27;13;48;33;15;30;43;19;53;64;26;42;314;40;81
06.03.2023 13:00;128;274;24;23;53;30;14;42;62;28;47;71;21;68;402;47;83
06.03.2023 14:00;150;244;36;9;53;45;13;51;78;28;54;100;30;69;394;45;98
06.03.2023 15:00;187;329;45;23;91;63;22;53;75;36;79;107;34;90;516;68;154
06.03.2023 16:00;200;382;62;31;114;81;22;90;106;34;95;146;41;96;582;93;195
06.03.2023 17:00;193;439;60;30;141;107;36;70;132;37;89;196;37;113;632;90;248
06.03.2023 18:00;184;361;38;19;91;83;19;69;105;37;73;179;43;103;545;57;174
06.03.2023 19:00;122;236;23;10;40;31;10;24;38;12;34;67;10;40;358;33;71
06.03.2023 20:00;97;144;7;2;26;18;8;18;24;18;22;38;6;17;241;9;44
06.03.2023 21:00;64;123;3;3;12;7;3;5;13;3;20;19;5;10;187;6;19
06.03.2023 22:00;45;91;4;2;14;10;1;4;11;6;8;8;3;5;136;6;24
06.03.2023 23:00;10;19;1;1;6;2;0;0;3;3;9;2;0;6;29;2;8
07.03.2023 00:00;3;7;0;1;3;1;0;0;2;0;2;0;0;2;10;1;4
07.03.2023 01:00;2;6;3;0;1;0;0;0;0;1;0;1;0;0;8;3;1
07.03.2023 02:00;3;5;0;0;0;0;0;0;0;0;0;0;0;0;8;0;0
07.03.2023 03:00;0;3;0;0;3;0;0;0;1;0;2;0;0;0;3;0;3
07.03.2023 04:00;6;7;2;1;3;2;0;0;3;0;5;2;1;1;13;3;5
07.03.2023 05:00;39;33;8;4;15;6;1;7;6;2;14;15;4;8;72;12;21
07.03.2023 06:00;88;100;24;26;45;29;12;19;21;10;40;37;15;22;188;50;74
07.03.2023 07:00;322;281;59;50;134;133;27;97;119;44;86;148;48;137;603;109;267
07.03.2023 08:00;299;336;66;31;202;161;24;114;141;40;88;298;38;119;635;97;363
07.03.2023 09:00;166;189;17;13;79;69;7;46;55;19;37;108;23;55;355;30;148
07.03.2023 10:00;107;168;13;6;31;21;5;31;37;12;22;55;11;41;275;19;52
07.03.2023 11:00;93;171;9;8;32;37;3;25;34;16;33;69;16;38;264;17;69
07.03.2023 12:00;115;200;29;9;46;40;5;38;43;16;52;52;25;35;315;38;86
07.03.2023 13:00;112;250;29;14;54;48;10;46;60;37;54;67;21;57;362;43;102
07.03.2023 14:00;125;271;36;13;83;43;9;40;54;28;46;74;34;72;396;49;126
07.03.2023 15:00;153;319;54;8;72;78;15;72;93;34;78;104;24;73;472;62;150
07.03.2023 16:00;158;333;42;18;92;67;14;46;93;33;83;107;24;61;491;60;159
07.03.2023 17:00;141;313;39;16;133;87;13;59;99;20;61;137;25;63;454;55;220
07.03.2023 18:00;133;280;35;16;82;53;9;36;52;24;52;109;29;61;413;51;135
07.03.2023 19:00;85;202;15;2;40;26;5;17;20;12;40;40;6;25;287;17;66
07.03.2023 20:00;73;106;10;2;22;14;0;8;12;6;14;20;4;17;179;12;36
07.03.2023 21:00;30;88;4;1;10;8;1;5;7;2;6;19;4;6;118;5;18
07.03.2023 22:00;39;58;5;1;6;6;1;4;5;7;4;5;1;5;97;6;12
07.03.2023 23:00;14;26;2;1;2;3;0;2;2;3;7;6;0;1;40;3;5
08.03.2023 00:00;7;6;0;1;2;0;0;0;0;0;4;2;1;0;13;1;2
08.03.2023 01:00;0;4;0;1;1;0;0;0;1;0;2;0;0;1;4;1;1
08.03.2023 02:00;1;2;0;0;1;0;0;0;1;0;1;0;0;0;3;0;1
08.03.2023 03:00;4;1;1;0;2;0;1;0;0;0;2;0;0;0;5;1;2
08.03.2023 04:00;4;7;0;1;3;3;0;0;3;0;2;1;0;1;11;1;6
08.03.2023 05:00;26;25;7;4;15;4;3;4;2;2;9;14;3;3;51;11;19
08.03.2023 06:00;58;68;9;5;31;15;9;6;20;6;24;20;6;15;126;14;46
08.03.2023 07:00;171;160;35;27;58;51;12;34;59;18;51;70;20;65;331;62;109
08.03.2023 08:00;162;155;26;16;106;77;5;47;52;15;38;111;18;48;317;42;183
08.03.2023 09:00;88;116;11;5;33;29;2;23;28;6;34;52;7;19;204;16;62
08.03.2023 10:00;42;70;6;2;15;7;2;11;13;2;10;17;3;13;112;8;22
08.03.2023 11:00;56;80;5;2;6;15;2;15;15;11;11;22;5;25;136;7;21
08.03.2023 12:00;70;108;14;3;21;12;6;13;19;6;23;37;10;17;178;17;33
08.03.2023 13:00;71;163;17;8;37;30;5;19;28;14;28;45;17;31;234;25;67
08.03.2023 14:00;89;166;17;11;26;25;7;25;36;20;30;43;13;32;255;28;51
08.03.2023 15:00;88;162;23;11;44;19;4;38;50;19;52;57;20;44;250;34;63
08.03.2023 16:00;93;191;32;14;57;41;12;30;50;18;35;74;13;34;284;46;98
08.03.2023 17:00;104;229;19;14;64;45;8;34;54;21;57;69;14;47;333;33;109
08.03.2023 18:00;109;222;30;10;58;43;5;26;39;25;25;77;18;43;331;40;101
08.03.2023 19:00;100;152;15;5;23;26;1;19;28;17;23;28;3;33;252;20;49
08.03.2023 20:00;58;131;7;3;20;8;0;14;8;11;21;17;9;9;189;10;28
08.03.2023 21:00;62;84;5;3;12;6;1;10;11;5;10;11;7;15;146;8;18
08.03.2023 22:00;40;76;4;2;13;8;2;2;5;5;12;6;1;3;116;6;21
08.03.2023 23:00;20;47;3;0;3;0;0;5;2;3;3;12;2;1;67;3;3
09.03.2023 00:00;6;9;0;1;3;1;0;0;1;0;3;1;0;1;15;1;4
09.03.2023 01:00;3;4;1;0;1;0;0;0;2;0;0;0;0;0;7;1;1
09.03.2023 02:00;0;1;0;0;0;0;0;0;1;0;1;2;0;0;1;0;0
09.03.2023 03:00;3;3;1;0;3;0;1;1;0;0;0;0;0;0;6;1;3
09.03.2023 04:00;4;9;2;2;4;1;0;0;2;1;1;1;0;1;13;4;5
09.03.2023 05:00;32;27;8;1;15;7;1;3;3;1;7;11;1;6;59;9;22
09.03.2023 06:00;59;61;11;10;29;13;7;14;18;5;33;26;14;11;120;21;42
09.03.2023 07:00;184;169;41;24;61;57;18;41;52;23;61;79;37;55;353;65;118
09.03.2023 08:00;188;211;37;15;103;77;13;56;64;18;51;162;27;60;399;52;180
09.03.2023 09:00;86;107;12;2;35;22;8;28;31;12;21;59;16;43;193;14;57
09.03.2023 10:00;67;72;6;5;18;13;6;11;14;10;18;28;7;20;139;11;31
09.03.2023 11:00;63;91;12;7;25;15;4;9;16;8;23;40;12;25;154;19;40
09.03.2023 12:00;79;158;14;7;27;23;4;25;23;14;31;50;21;28;237;21;50
09.03.2023 13:00;99;171;19;8;41;32;7;23;51;24;29;53;15;48;270;27;73
09.03.2023 14:00;104;186;21;11;32;23;14;34;27;14;42;48;20;30;290;32;55
09.03.2023 15:00;118;222;22;15;50;38;9;51;47;24;44;86;21;61;340;37;88
09.03.2023 16:00;148;267;44;16;90;47;16;72;63;28;68;106;38;82;415;60;137
09.03.2023 17:00;163;310;53;33;95;68;24;79;123;40;67;160;57;108;473;86;163
09.03.2023 18:00;176;299;46;17;75;43;13;64;81;38;62;150;58;88;475;63;118
09.03.2023 19:00;100;221;16;6;31;14;5;28;40;19;44;41;19;59;321;22;45
09.03.2023 20:00;70;126;15;2;21;9;0;11;9;12;20;24;6;21;196;17;30
09.03.2023 21:00;50;92;6;2;20;10;2;16;14;4;17;22;9;18;142;8;30
09.03.2023 22:00;44;89;13;1;11;7;1;5;10;4;15;14;3;11;133;14;18
09.03.2023 23:00;17;42;2;1;6;3;0;1;6;5;16;4;1;5;59;3;9
10.03.2023 00:00;9;23;0;2;6;4;0;0;3;2;2;2;1;1;32;2;10
10.03.2023 01:00;1;6;2;1;0;0;0;1;1;0;5;1;0;2;7;3;0
10.03.2023 02:00;2;10;0;0;1;0;0;0;1;0;0;0;0;0;12;0;1
10.03.2023 03:00;0;2;0;0;2;0;0;0;0;0;1;0;0;0;2;0;2
10.03.2023 04:00;1;10;0;2;2;2;0;0;2;0;5;1;0;1;11;2;4
10.03.2023 05:00;28;33;7;6;13;9;1;3;5;1;13;12;4;5;61;13;22
10.03.2023 06:00;72;78;15;16;37;18;13;14;23;3;32;22;8;19;150;31;55
10.03.2023 07:00;269;239;55;32;91;84;23;54;79;32;73;114;28;105;508;87;175
10.03.2023 08:00;249;257;42;19;121;89;13;83;111;38;82;196;31;105;506;61;210
10.03.2023 09:00;144;214;30;11;53;65;13;48;59;23;61;111;25;65;358;41;118
10.03.2023 10:00;133;187;6;13;31;29;17;35;51;17;43;43;35;70;320;19;60
10.03.2023 11:00;115;239;22;13;38;33;17;66;82;27;50;77;45;82;354;35;71
10.03.2023 12:00;141;248;34;6;41;28;21;55;60;21;58;80;33;48;389;40;69
10.03.2023 13:00;111;277;24;13;45;36;10;22;47;31;63;59;21;45;388;37;81
10.03.2023 14:00;113;242;27;18;60;40;13;34;38;24;64;58;14;41;355;45;100
10.03.2023 15:00;127;242;22;18;58;38;11;40;45;35;55;77;21;46;369;40;96
10.03.2023 16:00;105;251;34;12;72;33;14;38;39;17;44;77;18;40;356;46;105
10.03.2023 17:00;105;243;22;11;56;46;13;34;48;18;44;73;28;36;348;33;102
10.03.2023 18:00;100;175;12;5;34;21;5;28;25;15;26;50;10;24;275;17;55
10.03.2023 19:00;62;129;11;2;16;6;0;7;15;5;31;23;9;17;191;13;22
10.03.2023 20:00;59;92;10;3;6;9;0;6;5;4;7;12;0;9;151;13;15
10.03.2023 21:00;25;75;4;4;10;4;1;3;8;5;9;8;5;13;100;8;14
10.03.2023 22:00;23;50;1;2;6;1;0;3;1;2;12;1;2;0;73;3;7
10.03.2023 23:00;27;38;3;1;3;4;0;3;3;2;8;6;0;1;65;4;7
11.03.2023 00:00;10;28;1;2;0;0;0;3;2;1;6;4;1;2;38;3;0
11.03.2023 01:00;6;23;1;0;7;2;0;1;0;1;0;1;2;0;29;1;9
11.03.2023 02:00;1;3;2;0;0;1;1;1;2;2;2;1;0;1;4;2;1
11.03.2023 03:00;0;1;0;0;4;1;0;0;0;0;1;2;0;0;1;0;5
11.03.2023 04:00;5;4;1;2;0;1;0;1;0;3;5;1;0;3;9;3;1
11.03.2023 05:00;4;8;1;3;4;5;0;0;2;1;4;2;0;0;12;4;9
11.03.2023 06:00;14;23;4;1;1;2;2;0;3;0;8;3;1;4;37;5;3
11.03.2023 07:00;18;21;7;3;9;8;1;6;7;0;9;12;1;8;39;10;17
11.03.2023 08:00;42;73;13;8;10;12;14;7;16;17;24;27;13;23;115;21;22
11.03.2023 09:00;100;126;17;14;29;18;9;31;40;20;25;35;19;53;226;31;47
11.03.2023 10:00;106;195;36;18;33;35;20;52;82;36;23;92;50;95;301;54;68
11.03.2023 11:00;134;234;38;17;48;50;46;69;84;62;34;75;33;107;368;55;98
11.03.2023 12:00;176;237;36;23;62;41;44;85;118;38;38;107;68;123;413;59;103
11.03.2023 13:00;197;286;67;21;76;59;47;66;128;46;70;122;66;128;483;88;135
11.03.2023 14:00;158;332;57;30;73;64;37;80;153;39;53;125;73;163;490;87;137
11.03.2023 15:00;153;272;37;39;65;76;56;120;147;38;49;147;77;126;425;76;141
11.03.2023 16:00;115;259;42;24;72;90;42;103;145;45;42;141;68;155;374;66;162
11.03.2023 17:00;145;245;48;27;57;70;43;101;123;29;37;113;63;158;390;75;127
11.03.2023 18:00;146;243;30;25;50;44;16;53;83;12;27;90;41;92;389;55;94
11.03.2023 19:00;126;188;12;0;27;16;10;27;41;15;25;36;32;35;314;12;43
11.03.2023 20:00;67;103;6;0;16;13;1;11;14;8;9;21;7;11;170;6;29
11.03.2023 21:00;55;72;5;1;16;8;4;2;10;0;14;10;6;14;127;6;24
11.03.2023 22:00;56;85;4;2;8;3;1;7;10;1;8;11;5;5;141;6;11
11.03.2023 23:00;53;74;3;0;9;2;0;2;11;2;6;3;4;12;127;3;11
12.03.2023 00:00;27;69;4;0;10;3;0;4;9;0;5;13;3;1;96;4;13
12.03.2023 01:00;15;46;1;0;7;0;0;1;6;3;1;2;1;6;61;1;7
12.03.2023 02:00;10;20;2;1;3;1;2;0;0;2;2;0;3;0;30;3;4
12.03.2023 03:00;8;13;3;0;0;0;0;0;0;0;1;1;0;1;21;3;0
12.03.2023 04:00;5;13;4;1;1;1;1;3;1;2;0;3;1;0;18;5;2
12.03.2023 05:00;6;14;1;2;3;4;1;1;0;1;1;7;3;0;20;3;7
12.03.2023 06:00;9;9;2;1;3;1;2;0;2;1;9;3;0;2;18;3;4
12.03.2023 07:00;7;13;2;3;4;4;1;5;3;0;3;2;1;4;20;5;8
12.03.2023 08:00;20;32;13;1;5;7;4;5;10;2;8;13;7;10;52;14;12
12.03.2023 09:00;29;60;14;1;22;15;6;16;34;6;15;24;9;29;89;15;37
12.03.2023 10:00;38;71;13;7;21;7;6;41;23;10;12;35;19;23;109;20;28
12.03.2023 11:00;40;72;9;5;15;16;10;32;33;11;18;28;18;36;112;14;31
12.03.2023 12:00;51;106;18;3;24;31;6;34;66;11;18;55;30;54;157;21;55
12.03.2023 13:00;63;136;33;12;34;43;27;61;70;17;30;77;55;66;199;45;77
12.03.2023 14:00;102;168;51;20;49;45;27;79;109;36;16;107;56;87;270;71;94
12.03.2023 15:00;111;181;50;20;62;60;29;71;127;42;14;131;49;108;292;70;122
12.03.2023 16:00;89;153;43;29;59;68;43;106;121;35;38;114;61;99;242;72;127
12.03.2023 17:00;102;156;33;15;56;58;34;75;102;32;20;105;50;93;258;48;114
12.03.2023 18:00;93;138;26;20;35;32;18;36;42;24;20;61;31;38;231;46;67
12.03.2023 19:00;70;110;6;6;21;10;11;11;18;9;10;28;14;26;180;12;31
12.03.2023 20:00;59;60;5;0;13;6;1;4;13;11;15;15;6;13;119;5;19
12.03.2023 21:00;35;64;3;3;10;4;4;4;5;1;9;4;4;11;99;6;14
12.03.2023 22:00;26;39;3;1;4;4;0;1;7;0;10;3;4;6;65;4;8
12.03.2023 23:00;8;16;2;2;2;2;0;0;3;1;2;2;0;0;24;4;4
13.03.2023 00:00;10;8;1;0;1;2;0;0;2;0;1;0;0;2;18;1;3
13.03.2023 01:00;1;1;0;0;0;0;0;0;1;0;2;1;0;1;2;0;0
13.03.2023 02:00;1;2;0;0;0;0;0;0;1;0;1;0;0;0;3;0;0
13.03.2023 03:00;1;2;0;0;1;1;0;0;0;0;2;1;0;0;3;0;2
13.03.2023 04:00;2;6;1;0;4;1;1;0;1;0;6;2;0;0;8;1;5
13.03.2023 05:00;27;33;10;9;20;7;2;5;9;3;12;14;9;6;60;19;27
13.03.2023 06:00;103;93;29;30;47;36;22;16;38;8;38;43;16;31;196;59;83
13.03.2023 07:00;365;321;86;61;154;147;40;112;119;53;108;186;60;139;686;147;301
13.03.2023 08:00;325;340;63;28;180;166;34;109;151;43;100;286;45;134;665;91;346
13.03.2023 09:00;173;180;28;7;74;53;7;51;72;24;50;128;18;71;353;35;127
13.03.2023 10:00;99;147;19;9;25;35;11;26;48;12;31;50;14;41;246;28;60
13.03.2023 11:00;130;155;15;11;32;35;11;27;56;14;43;62;19;61;285;26;67
13.03.2023 12:00;122;204;22;12;40;36;15;55;58;24;49;78;34;51;326;34;76
13.03.2023 13:00;140;252;35;19;59;55;28;50;84;38;56;104;25;92;392;54;114
13.03.2023 14:00;144;263;41;19;68;69;29;65;100;45;53;100;34;94;407;60;137
13.03.2023 15:00;180;352;60;19;120;78;25;90;121;46;73;138;50;115;532;79;198
13.03.2023 16:00;254;454;84;25;130;112;43;100;139;38;98;183;53;113;708;109;242
13.03.2023 17:00;249;479;93;41;162;125;43;140;215;69;102;282;85;205;728;134;287
13.03.2023 18:00;225;460;54;28;129;94;39;107;162;53;72;240;71;170;685;82;223
13.03.2023 19:00;156;297;22;14;58;49;10;38;70;26;42;85;26;77;453;36;107
13.03.2023 20:00;100;194;12;7;33;23;4;30;30;16;20;41;14;29;294;19;56
13.03.2023 21:00;82;131;10;1;20;14;3;7;27;8;28;31;7;36;213;11;34
13.03.2023 22:00;62;97;2;10;21;8;8;4;24;15;15;11;1;23;159;12;29
13.03.2023 23:00;21;41;2;1;3;3;0;0;8;1;6;3;0;4;62;3;6
14.03.2023 00:00;7;10;1;0;3;2;0;1;3;2;1;3;0;2;17;1;5
14.03.2023 01:00;4;5;3;0;2;1;0;0;0;0;4;0;1;0;9;3;3
14.03.2023 02:00;2;2;0;1;1;0;1;1;2;0;0;0;0;1;4;1;1
14.03.2023 03:00;0;5;0;2;3;1;0;0;0;0;0;0;0;0;5;2;4
14.03.2023 04:00;5;7;0;0;5;1;0;0;1;0;4;3;1;0;12;0;6
14.03.2023 05:00;30;27;6;5;18;12;2;3;9;3;12;8;1;7;57;11;30
14.03.2023 06:00;87;93;14;20;37;37;9;24;21;6;37;35;17;16;180;34;74
14.03.2023 07:00;336;285;79;45;129;114;21;80;106;42;111;164;54;128;621;124;243
14.03.2023 08:00;360;359;69;37;186;203;30;113;165;54;91;316;44;151;719;106;389
14.03.2023 09:00;191;210;25;9;77;55;17;64;83;21;60;142;20;73;401;34;132
14.03.2023 10:00;83;149;11;6;30;28;10;24;36;23;27;39;20;36;232;17;58
14.03.2023 11:00;74;120;10;5;26;14;4;21;15;16;21;23;12;16;194;15;40
14.03.2023 12:00;97;166;22;8;25;29;6;14;25;16;30;48;6;23;263;30;54
14.03.2023 13:00;64;206;19;9;36;33;11;18;32;20;34;49;10;26;270;28;69
14.03.2023 14:00;92;228;24;7;35;30;10;23;36;31;40;56;24;44;320;31;65
14.03.2023 15:00;141;237;31;9;62;56;17;32;45;38;57;64;13;48;378;40;118
14.03.2023 16:00;159;353;52;18;119;85;22;45;94;35;85;127;23;84;512;70;204
14.03.2023 17:00;199;395;53;20;132;103;23;77;133;32;60;177;37;105;594;73;235
14.03.2023 18:00;177;382;61;20;97;74;18;61;100;41;54;136;34;98;559;81;171
14.03.2023 19:00;119;262;23;7;41;36;5;29;47;17;55;58;24;43;381;30;77
14.03.2023 20:00;71;157;14;6;20;13;2;16;21;14;26;31;8;19;228;20;33
14.03.2023 21:00;87;130;11;2;21;9;0;10;13;10;24;31;3;23;217;13;30
14.03.2023 22:00;43;107;3;6;18;15;1;3;14;3;26;11;4;7;150;9;33
14.03.2023 23:00;22;40;2;2;4;3;0;2;3;3;14;6;0;2;62;4;7
15.03.2023 00:00;4;9;1;0;1;0;0;0;2;0;4;1;0;0;13;1;1
15.03.2023 01:00;0;7;0;0;0;0;0;0;0;0;0;0;0;0;7;0;0
15.03.2023 02:00;1;1;0;0;0;1;0;0;3;1;0;2;0;1;2;0;1
15.03.2023 03:00;0;1;1;0;2;0;0;1;0;0;3;2;0;0;1;1;2
15.03.2023 04:00;6;9;1;2;9;1;0;0;2;0;3;1;1;1;15;3;10
15.03.2023 05:00;24;23;12;6;12;8;2;4;5;1;9;13;2;2;47;18;20
15.03.2023 06:00;79;83;17;19;34;24;11;15;21;5;31;28;14;18;162;36;58
15.03.2023 07:00;267;263;76;31;104;111;22;80;105;34;84;152;43;131;530;107;215
15.03.2023 08:00;331;352;50;35;163;154;26;105;152;41;95;303;31;129;683;85;317
15.03.2023 09:00;148;194;16;13;71;60;7;54;65;28;35;130;19;69;342;29;131
15.03.2023 10:00;96;153;20;6;19;30;8;20;26;21;35;47;10;33;249;26;49
15.03.2023 11:00;105;172;13;14;25;32;15;34;34;16;38;54;23;36;277;27;57
15.03.2023 12:00;119;240;29;13;39;25;20;58;58;29;51;74;31;71;359;42;64
15.03.2023 13:00;137;274;37;15;69;47;25;54;69;35;52;110;35;71;411;52;116
15.03.2023 14:00;152;280;42;30;68;64;15;56;117;48;53;129;38;124;432;72;132
15.03.2023 15:00;160;374;55;37;88;93;37;104;139;57;69;180;57;131;534;92;181
15.03.2023 16:00;250;432;91;36;137;114;48;119;212;61;97;201;81;190;682;127;251
15.03.2023 17:00;223;497;72;46;151;137;43;127;215;63;112;282;74;206;720;118;288
15.03.2023 18:00;253;418;59;30;106;93;27;88;157;41;75;217;65;150;671;89;199
15.03.2023 19:00;154;280;31;13;50;41;12;27;49;30;57;70;11;70;434;44;91
15.03.2023 20:00;101;195;17;4;37;26;2;12;30;8;22;54;4;33;296;21;63
15.03.2023 21:00;99;125;13;5;18;11;4;6;23;5;18;28;1;33;224;18;29
15.03.2023 22:00;63;135;8;1;18;7;1;4;13;7;21;15;2;15;198;9;25
15.03.2023 23:00;33;52;4;0;5;0;0;2;8;4;9;6;0;4;85;4;5
16.03.2023 00:00;5;19;2;0;4;2;0;2;5;0;2;2;0;2;24;2;6
16.03.2023 01:00;2;7;5;2;0;1;0;0;0;1;5;1;2;1;9;7;1
16.03.2023 02:00;1;3;0;0;0;0;0;1;0;0;3;1;0;0;4;0;0
16.03.2023 03:00;0;3;1;0;2;1;0;0;0;1;5;0;0;0;3;1;3
16.03.2023 04:00;4;8;2;0;4;0;0;1;2;0;5;5;2;1;12;2;4
16.03.2023 05:00;33;29;13;8;22;9;2;3;6;2;10;9;2;6;62;21;31
16.03.2023 06:00;91;113;31;29;66;38;21;29;33;4;42;41;23;18;204;60;104
16.03.2023 07:00;380;319;80;42;152;138;38;117;140;42;96;198;72;154;699;122;290
16.03.2023 08:00;341;379;60;34;214;200;33;135;187;44;91;336;54;149;720;94;414
16.03.2023 09:00;178;253;29;17;88;82;14;49;98;21;49;146;30;78;431;46;170
16.03.2023 10:00;133;180;15;17;40;40;11;42;40;11;37;65;20;46;313;32;80
16.03.2023 11:00;109;214;23;18;46;48;16;29;56;14;38;66;25;59;323;41;94
16.03.2023 12:00;125;248;40;17;68;43;23;49;71;30;48;81;33;66;373;57;111
16.03.2023 13:00;169;311;44;23;73;55;25;52;100;40;47;114;32;113;480;67;128
16.03.2023 14:00;207;326;46;34;78;58;25;66;108;40;52;126;58;94;533;80;136
16.03.2023 15:00;195;409;76;25;117;102;42;118;130;65;85;156;56;135;604;101;219
16.03.2023 16:00;240;501;94;56;191;114;50;107;182;65;86;214;71;199;741;150;305
16.03.2023 17:00;273;542;94;39;181;140;65;138;240;58;94;283;85;204;815;133;321
16.03.2023 18:00;232;454;59;42;137;105;33;104;124;46;91;210;65;152;686;101;242
16.03.2023 19:00;179;353;19;10;72;46;9;28;77;23;55;82;23;82;532;29;118
16.03.2023 20:00;89;174;17;13;48;26;7;15;29;17;36;36;9;36;263;30;74
16.03.2023 21:00;97;164;7;1;29;16;2;16;28;6;35;32;9;24;261;8;45
16.03.2023 22:00;64;116;4;3;17;5;2;2;16;12;23;20;5;19;180;7;22
16.03.2023 23:00;52;69;4;1;7;1;0;4;6;11;12;2;1;9;121;5;8
17.03.2023 00:00;12;28;3;1;5;4;0;2;2;3;2;7;1;2;40;4;9
17.03.2023 01:00;0;13;0;1;0;1;0;0;1;0;3;2;0;1;13;1;1
17.03.2023 02:00;3;6;0;0;0;0;0;0;0;0;1;0;0;1;9;0;0
17.03.2023 03:00;4;3;0;0;3;1;0;0;1;0;3;1;0;0;7;0;4
17.03.2023 04:00;7;9;0;1;5;1;0;1;2;0;9;2;1;2;16;1;6
17.03.2023 05:00;32;34;10;13;16;13;10;6;6;3;7;15;3;6;66;23;29
17.03.2023 06:00;97;106;35;23;46;33;19;20;40;4;43;38;20;34;203;58;79
17.03.2023 07:00;314;294;67;49;126;106;25;104;128;37;86;144;64;157;608;116;232
17.03.2023 08:00;325;314;54;21;152;127;26;132;131;42;84;249;45;125;639;75;279
17.03.2023 09:00;185;254;40;17;64;70;17;64;88;20;57;115;29;74;439;57;134
17.03.2023 10:00;149;216;36;23;51;45;21;61;86;23;43;87;56;100;365;59;96
17.03.2023 11:00;152;258;34;19;68;55;26;92;119;32;57;140;79;105;410;53;123
17.03.2023 12:00;185;343;52;24;72;62;35;113;172;38;69;162;90;173;528;76;134
17.03.2023 13:00;221;435;69;39;106;110;51;137;191;83;88;183;84;214;656;108;216
17.03.2023 14:00;227;450;104;39;127;99;63;135;210;58;59;197;91;204;677;143;226
17.03.2023 15:00;260;451;82;42;157;113;74;155;190;66;95;197;102;213;711;124;270
17.03.2023 16:00;222;438;101;41;128;100;70;157;205;61;69;236;92;184;660;142;228
17.03.2023 17:00;198;415;55;25;114;74;42;118;181;78;61;181;64;156;613;80;188
17.03.2023 18:00;213;373;47;24;76;75;26;66;122;55;53;130;55;118;586;71;151
17.03.2023 19:00;196;284;18;6;41;32;11;45;44;29;48;61;19;59;480;24;73
17.03.2023 20:00;100;152;13;5;22;14;2;7;21;9;29;18;7;21;252;18;36
17.03.2023 21:00;70;114;6;0;21;11;3;10;13;15;24;19;8;23;184;6;32
17.03.2023 22:00;62;132;10;2;11;9;3;6;8;6;28;11;6;14;194;12;20
17.03.2023 23:00;52;84;5;0;6;6;0;5;5;1;10;19;1;3;136;5;12
18.03.2023 00:00;26;70;5;2;5;3;1;2;9;3;7;15;1;6;96;7;8
18.03.2023 01:00;15;37;4;0;7;3;0;3;6;0;5;3;1;4;52;4;10
18.03.2023 02:00;2;23;1;0;3;3;0;0;4;2;4;0;1;3;25;1;6
18.03.2023 03:00;5;11;2;0;2;0;0;0;0;0;4;1;0;0;16;2;2
18.03.2023 04:00;3;10;1;0;0;0;0;1;0;1;3;2;0;1;13;1;0
18.03.2023 05:00;9;13;4;2;10;2;2;0;5;0;4;4;1;1;22;6;12
18.03.2023 06:00;16;13;3;3;7;1;2;4;3;1;7;5;2;3;29;6;8
18.03.2023 07:00;20;36;9;4;11;13;5;18;17;3;4;14;11;10;56;13;24
18.03.2023 08:00;49;81;24;10;28;32;12;27;41;11;22;36;16;33;130;34;60
18.03.2023 09:00;129;165;27;20;49;51;23;53;87;30;31;83;53;88;294;47;100
18.03.2023 10:00;177;233;60;46;87;55;45;128;124;43;34;145;101;122;410;106;142
18.03.2023 11:00;186;319;67;34;114;92;72;165;207;51;74;206;155;216;505;101;206
18.03.2023 12:00;219;357;98;43;111;112;99;223;229;60;56;239;153;251;576;141;223
18.03.2023 13:00;246;403;81;59;116;109;84;195;278;71;55;282;146;249;649;140;225
18.03.2023 14:00;206;394;80;69;129;102;85;217;284;72;62;231;152;287;600;149;231
18.03.2023 15:00;165;393;72;31;138;80;73;162;191;26;32;216;103;181;558;103;218
18.03.2023 16:00;197;325;63;35;109;91;66;168;205;84;43;198;116;209;522;98;200
18.03.2023 17:00;171;336;60;44;70;89;59;133;210;68;42;154;96;211;507;104;159
18.03.2023 18:00;171;298;50;22;85;66;44;96;149;57;36;149;67;126;469;72;151
18.03.2023 19:00;152;250;11;14;39;32;10;47;61;19;22;66;33;52;402;25;71
18.03.2023 20:00;78;147;5;8;20;17;3;17;35;15;19;41;12;21;225;13;37
18.03.2023 21:00;77;112;8;4;13;11;1;11;11;12;25;22;4;17;189;12;24
18.03.2023 22:00;64;115;7;3;13;7;3;8;12;5;10;13;5;13;179;10;20
18.03.2023 23:00;37;77;4;1;10;11;0;1;13;0;8;9;3;18;114;5;21
19.03.2023 00:00;46;58;3;0;8;9;0;4;7;2;11;9;0;9;104;3;17
19.03.2023 01:00;21;43;0;1;12;10;0;1;6;4;5;3;3;8;64;1;22
19.03.2023 02:00;10;36;0;0;4;0;0;1;2;2;4;1;2;1;46;0;4
19.03.2023 03:00;11;19;3;0;2;1;0;0;1;0;0;0;0;4;30;3;3
19.03.2023 04:00;2;7;2;0;0;1;0;1;3;0;0;3;0;1;9;2;1
19.03.2023 05:00;5;5;3;1;5;2;1;0;4;1;4;1;0;2;10;4;7
19.03.2023 06:00;5;10;2;2;3;1;2;4;3;3;4;4;5;4;15;4;4
19.03.2023 07:00;14;14;12;3;8;14;6;11;11;0;9;17;14;8;28;15;22
19.03.2023 08:00;29;72;13;5;23;17;11;27;28;5;10;34;22;28;101;18;40
19.03.2023 09:00;39;98;37;17;45;37;15;45;62;15;21;74;40;49;137;54;82
19.03.2023 10:00;100;125;44;11;40;28;21;41;74;13;25;81;36;63;225;55;68
19.03.2023 11:00;93;103;41;15;40;43;26;56;70;22;19;77;46;62;196;56;83
19.03.2023 12:00;104;166;41;17;46;51;47;98;99;37;22;99;70;109;270;58;97
19.03.2023 13:00;99;165;58;17;57;55;40;73;99;49;20;139;53;69;264;75;112
19.03.2023 14:00;115;169;22;20;64;52;22;72;102;45;30;93;51;79;284;42;116
19.03.2023 15:00;109;173;27;21;55;47;18;114;105;29;31;87;72;92;282;48;102
19.03.2023 16:00;140;199;49;19;66;70;45;153;142;47;30;176;100;158;339;68;136
19.03.2023 17:00;125;180;34;16;51;55;15;100;106;38;30;79;94;113;305;50;106
19.03.2023 18:00;76;116;14;13;36;14;21;34;45;16;21;42;47;16;192;27;50
19.03.2023 19:00;81;127;9;6;15;9;2;15;21;14;14;23;21;21;208;15;24
19.03.2023 20:00;61;84;4;3;15;14;1;4;15;7;16;15;4;19;145;7;29
19.03.2023 21:00;33;41;2;1;7;4;1;8;5;2;8;9;3;11;74;3;11
19.03.2023 22:00;31;46;2;5;4;1;2;2;6;2;4;3;3;6;77;7;5
19.03.2023 23:00;19;19;0;0;3;1;0;1;5;5;6;3;0;6;38;0;4
20.03.2023 00:00;3;10;1;0;3;0;0;0;2;2;5;0;0;0;13;1;3
20.03.2023 01:00;1;3;0;0;0;0;0;0;0;0;3;0;0;0;4;0;0
20.03.2023 02:00;2;5;0;0;0;0;0;1;2;0;3;0;0;1;7;0;0
20.03.2023 03:00;1;1;1;3;1;0;0;0;1;0;0;0;0;1;2;4;1
20.03.2023 04:00;4;13;1;1;3;1;2;0;4;0;6;2;1;2;17;2;4
20.03.2023 05:00;47;42;10;11;26;13;2;6;8;2;26;17;3;8;89;21;39
20.03.2023 06:00;165;150;46;42;71;46;27;35;59;13;61;67;34;51;315;88;117
20.03.2023 07:00;551;521;105;107;206;222;87;165;207;62;137;293;74;215;1072;212;428
20.03.2023 08:00;532;461;81;46;249;212;51;158;229;77;160;419;65;201;993;127;461
20.03.2023 09:00;282;292;49;24;99;73;26;85;108;38;97;207;39;108;574;73;172
20.03.2023 10:00;156;231;34;23;47;48;36;59;66;25;58;95;55;85;387;57;95
20.03.2023 11:00;166;273;40;23;61;41;26;71;96;30;78;114;61;105;439;63;102
20.03.2023 12:00;203;295;43;13;73;64;18;70;95;30;79;110;53;95;498;56;137
20.03.2023 13:00;190;411;29;22;79;89;37;58;124;49;81;131;46;128;601;51;168
20.03.2023 14:00;218;408;76;18;77;94;32;87;125;44;88;123;53;97;626;94;171
20.03.2023 15:00;289;461;70;26;152;111;43;113;177;51;112;187;68;160;750;96;263
20.03.2023 16:00;325;656;97;38;186;147;65;144;190;71;158;268;63;172;981;135;333
20.03.2023 17:00;321;666;109;44;213;144;52;161;235;82;147;326;88;239;987;153;357
20.03.2023 18:00;253;546;68;36;160;90;40;106;186;55;87;282;64;173;799;104;250
20.03.2023 19:00;192;405;33;20;60;50;15;41;73;33;68;107;30;95;597;53;110
20.03.2023 20:00;143;235;15;4;40;26;3;17;38;13;29;53;9;37;378;19;66
20.03.2023 21:00;94;140;16;6;31;10;9;9;25;6;32;27;9;21;234;22;41
20.03.2023 22:00;69;143;3;4;18;10;1;5;16;10;29;25;4;19;212;7;28
20.03.2023 23:00;24;40;2;4;11;2;0;2;5;5;7;9;2;3;64;6;13
21.03.2023 00:00;7;16;0;0;3;1;0;1;1;0;2;1;0;0;23;0;4
21.03.2023 01:00;2;14;1;1;0;1;0;0;3;0;0;2;0;3;16;2;1
21.03.2023 02:00;0;5;0;0;0;0;0;0;2;0;1;0;0;1;5;0;0
21.03.2023 03:00;3;6;0;1;2;2;0;0;4;0;0;0;0;2;9;1;4
21.03.2023 04:00;5;12;1;0;4;2;0;0;4;1;9;2;1;5;17;1;6
21.03.2023 05:00;47;57;9;14;19;17;2;6;7;3;18;11;6;10;104;23;36
21.03.2023 06:00;138;154;44;33;73;44;19;39;37;12;70;74;26;40;292;77;117
21.03.2023 07:00;555;499;99;93;204;211;59;130;204;75;166;310;81;222;1054;192;415
21.03.2023 08:00;452;493;83;36;235;193;37;138;211;50;119;375;40;191;945;119;428
21.03.2023 09:00;189;219;28;11;64;58;17;43;51;13;62;138;15;35;408;39;122
21.03.2023 10:00;107;155;6;4;25;15;4;9;23;7;25;34;10;26;262;10;40
21.03.2023 11:00;117;182;18;7;29;19;1;24;33;21;40;38;11;37;299;25;48
21.03.2023 12:00;115;223;31;12;37;38;9;21;46;12;46;66;7;47;338;43;75
21.03.2023 13:00;146;334;35;18;54;63;25;25;65;39;71;90;12;79;480;53;117
21.03.2023 14:00;176;338;26;13;59;57;10;46;71;24;61;94;31;75;514;39;116
21.03.2023 15:00;224;432;66;21;105;108;28;96;147;49;100;161;40;117;656;87;213
21.03.2023 16:00;301;553;105;43;160;116;32;96;175;60;143;249;68;182;854;148;276
21.03.2023 17:00;328;663;102;42;229;152;61;144;291;79;121;340;81;253;991;144;381
21.03.2023 18:00;309;571;104;50;131;136;67;125;220;63;103;294;103;232;880;154;267
21.03.2023 19:00;227;362;33;13;84;55;11;43;76;29;77;108;25;90;589;46;139
21.03.2023 20:00;114;211;18;10;50;21;3;19;30;22;40;53;14;41;325;28;71
21.03.2023 21:00;94;180;9;5;23;23;7;14;23;8;32;46;11;20;274;14;46
21.03.2023 22:00;74;159;5;5;26;15;0;8;29;8;27;32;7;20;233;10;41
21.03.2023 23:00;44;62;5;3;7;9;0;3;5;2;21;9;0;7;106;8;16
22.03.2023 00:00;10;24;2;1;5;3;0;0;0;1;6;6;1;1;34;3;8
22.03.2023 01:00;5;12;0;0;1;0;1;1;2;1;0;2;1;0;17;0;1
22.03.2023 02:00;1;6;2;0;1;0;0;0;1;0;1;0;0;1;7;2;1
22.03.2023 03:00;1;3;0;0;2;0;0;0;1;0;0;0;0;0;4;0;2
22.03.2023 04:00;4;8;1;0;6;2;1;0;2;0;8;2;1;2;12;1;8
22.03.2023 05:00;34;36;9;9;17;9;4;2;8;3;16;10;4;10;70;18;26
22.03.2023 06:00;126;125;28;31;77;52;19;39;42;12;47;62;25;37;251;59;129
22.03.2023 07:00;410;342;74;71;191;176;60;129;177;57;122;246;86;179;752;145;367
22.03.2023 08:00;438;405;84;41;240;226;51;175;225;58;110;412;78;178;843;125;466
22.03.2023 09:00;210;256;35;15;94;80;18;102;103;33;66;167;38;99;466;50;174
22.03.2023 10:00;164;211;25;29;58;54;30;60;94;20;42;101;67;100;375;54;112
22.03.2023 11:00;177;241;30;19;56;56;31;65;87;24;43;118;42;105;418;49;112
22.03.2023 12:00;176;297;47;26;78;68;36;84;110;39;60;126;55;87;473;73;146
22.03.2023 13:00;175;312;59;17;91;80;29;76;121;41;60;132;64;106;487;76;171
22.03.2023 14:00;158;384;33;25;94;71;20;75;112;40;72;133;53;100;542;58;165
22.03.2023 15:00;201;355;60;41;136;109;36;86;148;52;86;158;61;121;556;101;245
22.03.2023 16:00;253;505;114;49;173;124;47;123;164;48;102;216;104;170;758;163;297
22.03.2023 17:00;267;564;97;53;189;134;39;150;243;58;124;328;78;185;831;150;323
22.03.2023 18:00;253;518;46;36;138;95;31;112;141;38;84;237;62;143;771;82;233
22.03.2023 19:00;173;332;26;17;61;51;12;42;67;28;55;88;29;84;505;43;112
22.03.2023 20:00;112;230;14;2;44;21;2;16;49;21;32;45;10;43;342;16;65
22.03.2023 21:00;117;174;12;2;20;18;5;12;16;13;32;22;10;32;291;14;38
22.03.2023 22:00;73;159;7;5;23;17;0;9;18;6;22;30;2;14;232;12;40
22.03.2023 23:00;33;55;4;0;7;5;0;5;4;2;14;6;1;4;88;4;12
23.03.2023 00:00;13;19;0;0;3;0;0;3;2;2;0;3;0;4;32;0;3
23.03.2023 01:00;4;11;2;0;3;0;0;0;1;0;1;0;0;0;15;2;3
23.03.2023 02:00;3;3;0;0;1;0;0;1;0;0;2;1;0;1;6;0;1
23.03.2023 03:00;1;4;0;0;2;0;0;1;2;0;2;1;0;0;5;0;2
23.03.2023 04:00;7;6;0;0;5;0;0;0;4;0;5;1;1;3;13;0;5
23.03.2023 05:00;39;39;6;7;28;9;3;6;9;2;17;11;4;12;78;13;37
23.03.2023 06:00;115;117;45;36;62;43;17;32;42;7;51;54;33;32;232;81;105
23.03.2023 07:00;416;315;80;69;190;160;44;156;169;57;100;236;79;194;731;149;350
23.03.2023 08:00;422;418;69;36;230;196;56;146;227;44;105;372;66;177;840;105;426
23.03.2023 09:00;181;237;33;25;92;81;14;61;73;29;47;171;42;81;418;58;173
23.03.2023 10:00;133;207;22;13;48;38;22;44;50;23;50;62;37;46;340;35;86
23.03.2023 11:00;116;221;30;14;44;37;19;39;65;21;42;86;28;67;337;44;81
23.03.2023 12:00;124;275;38;18;62;48;9;71;64;34;51;108;52;67;399;56;110
23.03.2023 13:00;149;295;40;11;82;67;25;70;96;27;66;117;35;104;444;51;149
23.03.2023 14:00;183;339;63;22;84;64;30;83;122;30;61;129;39;119;522;85;148
23.03.2023 15:00;235;413;57;27;141;107;31;112;163;65;72;183;58;145;648;84;248
23.03.2023 16:00;254;501;98;57;163;114;71;133;175;58;122;248;100;171;755;155;277
23.03.2023 17:00;267;550;109;37;205;195;52;158;261;58;106;309;83;232;817;146;400
23.03.2023 18:00;256;534;60;31;148;142;46;119;214;75;76;285;87;209;790;91;290
23.03.2023 19:00;183;374;40;28;81;54;18;61;63;32;43;118;42;101;557;68;135
23.03.2023 20:00;102;219;6;8;36;24;2;15;35;13;27;61;9;48;321;14;60
23.03.2023 21:00;92;155;19;8;26;10;1;15;28;6;23;27;9;21;247;27;36
23.03.2023 22:00;67;151;16;1;22;18;0;14;20;11;26;37;4;21;218;17;40
23.03.2023 23:00;36;60;6;1;14;6;3;5;10;5;13;9;2;13;96;7;20
24.03.2023 00:00;9;31;2;1;1;0;2;2;6;0;4;4;3;4;40;3;1
24.03.2023 01:00;3;14;1;0;4;1;2;0;0;0;2;3;0;0;17;1;5
24.03.2023 02:00;1;6;0;0;3;0;0;0;2;0;1;2;0;0;7;0;3
24.03.2023 03:00;1;5;1;0;5;0;0;1;1;0;3;1;1;0;6;1;5
24.03.2023 04:00;5;5;1;1;5;1;1;0;2;2;6;1;1;2;10;2;6
24.03.2023 05:00;32;35;6;8;11;8;5;10;7;1;9;16;5;7;67;14;19
24.03.2023 06:00;99;89;30;26;41;29;8;23;35;5;38;33;16;30;188;56;70
24.03.2023 07:00;294;266;68;55;93;101;25;80;108;52;83;136;52;122;560;123;194
24.03.2023 08:00;292;298;50;15;136;112;20;84;115;30;80;226;36;107;590;65;248
24.03.2023 09:00;178;217;33;11;70;53;20;51;67;22;48;125;25;62;395;44;123
24.03.2023 10:00;163;214;23;22;48;46;19;48;76;17;54;86;48;80;377;45;94
24.03.2023 11:00;162;261;50;15;59;46;29;73;119;31;63;112;55;120;423;65;105
24.03.2023 12:00;195;319;52;37;79;55;41;108;137;42;57;152;53;138;514;89;134
24.03.2023 13:00;188;412;69;32;112;75;43;109;175;71;101;193;78;151;600;101;187
24.03.2023 14:00;236;435;72;47;110;89;46;136;173;52;85;168;106;182;671;119;199
24.03.2023 15:00;208;375;88;35;125;96;48;125;166;61;78;215;90;148;583;123;221
24.03.2023 16:00;227;399;75;26;126;102;43;120;179;40;77;198;81;166;626;101;228
24.03.2023 17:00;214;409;45;22;107;90;45;107;163;47;62;191;71;159;623;67;197
24.03.2023 18:00;179;321;25;28;69;61;21;82;76;35;43;127;45;92;500;53;130
24.03.2023 19:00;132;295;22;16;57;31;8;34;59;21;31;67;26;49;427;38;88
24.03.2023 20:00;94;137;15;3;27;12;1;12;21;11;25;32;5;17;231;18;39
24.03.2023 21:00;71;131;17;1;18;9;4;9;19;10;17;26;9;19;202;18;27
24.03.2023 22:00;66;99;7;1;12;17;3;7;9;7;16;14;3;11;165;8;29
24.03.2023 23:00;33;80;6;3;4;11;3;5;10;3;5;9;3;11;113;9;15
25.03.2023 00:00;31;50;3;1;10;6;0;2;8;7;11;13;1;6;81;4;16
25.03.2023 01:00;14;46;1;0;7;2;1;2;4;0;5;5;0;5;60;1;9
25.03.2023 02:00;9;19;1;0;1;3;1;4;3;2;1;3;1;4;28;1;4
25.03.2023 03:00;4;8;2;0;2;0;0;1;1;0;2;1;0;0;12;2;2
25.03.2023 04:00;5;7;2;0;0;1;0;1;0;0;6;3;0;0;12;2;1
25.03.2023 05:00;9;23;0;1;4;5;0;2;2;0;1;3;2;2;32;1;9
25.03.2023 06:00;14;24;4;1;3;4;3;3;7;2;8;12;2;6;38;5;7
25.03.2023 07:00;20;36;10;4;14;5;2;10;19;2;8;30;6;9;56;14;19
25.03.2023 08:00;36;76;9;10;26;13;5;18;22;10;9;31;10;33;112;19;39
25.03.2023 09:00;91;133;24;11;36;16;6;21;42;12;40;47;21;38;224;35;52
25.03.2023 10:00;130;172;26;30;37;40;17;59;85;39;43;69;27;84;302;56;77
25.03.2023 11:00;138;176;31;14;35;28;32;68;73;58;41;86;60;89;314;45;63
25.03.2023 12:00;154;238;30;16;50;32;23;71;91;44;33;104;57;124;392;46;82
25.03.2023 13:00;150;243;36;25;59;52;30;64;105;54;43;99;59;97;393;61;111
25.03.2023 14:00;155;254;48;18;76;53;38;89;111;45;31;144;88;94;409;66;129
25.03.2023 15:00;114;209;19;14;56;30;17;79;74;24;20;116;54;73;323;33;86
25.03.2023 16:00;108;217;25;18;52;54;30;81;106;22;40;125;78;115;325;43;106
25.03.2023 17:00;127;232;25;19;52;55;29;77;122;42;33;103;66;105;359;44;107
25.03.2023 18:00;69;254;26;13;57;28;19;78;71;25;26;98;63;97;323;39;85
25.03.2023 19:00;27;179;22;10;56;23;5;41;51;7;23;38;29;54;206;32;79
25.03.2023 20:00;26;126;4;2;16;14;2;7;19;11;19;35;10;24;152;6;30
25.03.2023 21:00;0;82;8;4;10;10;0;7;13;4;9;19;8;12;82;12;20
25.03.2023 22:00;0;74;4;0;11;4;2;11;8;5;14;15;4;6;74;4;15
25.03.2023 23:00;0;72;6;0;15;6;1;9;8;8;7;5;1;10;72;6;21
26.03.2023 00:00;0;46;6;5;14;7;1;6;7;5;6;6;4;7;46;11;21
26.03.2023 01:00;0;38;1;2;8;5;0;4;3;1;3;3;3;4;38;3;13
26.03.2023 03:00;;;;;;;;;;;;;;;;;
26.03.2023 03:00;0;47;1;0;0;4;0;1;2;3;1;9;0;2;47;1;4
26.03.2023 04:00;0;18;3;0;1;0;0;0;0;4;4;0;1;1;18;3;1
26.03.2023 05:00;0;10;2;1;4;3;2;1;1;1;8;3;1;1;10;3;7
26.03.2023 06:00;0;6;2;3;5;3;3;5;3;1;1;1;0;4;6;5;8
26.03.2023 07:00;0;16;2;0;5;4;0;2;5;1;2;7;4;4;16;2;9
26.03.2023 08:00;0;25;6;3;5;6;0;2;11;3;3;8;5;6;25;9;11
26.03.2023 09:00;0;33;6;1;17;11;0;3;13;1;4;13;1;14;33;7;28
26.03.2023 10:00;0;41;6;0;12;7;0;9;10;4;7;11;7;9;41;6;19
26.03.2023 11:00;0;58;4;5;6;3;1;9;11;9;6;11;0;16;58;9;9
26.03.2023 12:00;0;78;7;2;14;15;7;19;33;6;14;32;15;34;78;9;29
26.03.2023 13:00;0;84;17;5;14;13;10;22;20;13;7;30;11;30;84;22;27
26.03.2023 14:00;0;83;8;4;12;8;18;11;19;8;12;27;15;22;83;12;20
26.03.2023 15:00;0;106;19;11;17;17;16;25;31;24;20;41;16;35;106;30;34
26.03.2023 16:00;0;93;10;8;18;21;12;21;32;27;28;41;17;37;93;18;39
26.03.2023 17:00;0;90;11;6;18;14;6;26;23;9;15;20;27;24;90;17;32
26.03.2023 18:00;0;118;25;5;16;23;12;20;34;11;29;34;12;44;118;30;39
26.03.2023 19:00;0;88;5;5;14;14;3;25;25;19;15;34;20;25;88;10;28
26.03.2023 20:00;0;47;14;1;8;11;2;4;12;2;20;12;7;12;47;15;19
26.03.2023 21:00;0;64;2;1;7;3;0;4;3;4;13;7;4;3;64;3;10
26.03.2023 22:00;0;37;1;1;5;2;0;5;6;6;14;3;1;7;37;2;7
26.03.2023 23:00;0;25;3;0;1;2;0;1;3;3;6;2;2;3;25;3;3
27.03.2023 00:00;0;7;1;0;0;1;0;0;2;1;1;2;0;1;7;1;1
27.03.2023 01:00;0;1;0;0;1;0;0;0;0;0;1;0;1;2;1;0;1
27.03.2023 02:00;0;2;0;0;1;0;0;1;1;0;0;0;0;0;2;0;1
27.03.2023 03:00;0;3;0;0;3;1;0;1;2;0;3;1;0;0;3;0;4
27.03.2023 04:00;0;10;2;2;5;2;2;1;1;0;10;3;1;1;10;4;7
27.03.2023 05:00;0;42;12;7;21;15;3;4;13;1;16;14;5;10;42;19;36
27.03.2023 06:00;0;99;30;30;53;49;24;28;38;14;54;63;30;35;99;60;102
27.03.2023 07:00;61;476;98;87;192;184;71;125;181;76;136;239;80;192;537;185;376
27.03.2023 08:00;0;474;86;39;203;185;50;178;187;55;144;404;55;172;474;125;388
27.03.2023 09:00;112;312;43;17;102;82;12;59;95;29;98;181;30;105;424;60;184
27.03.2023 10:00;154;209;28;17;46;30;11;45;60;15;54;84;24;69;363;45;76
27.03.2023 11:00;148;239;32;18;48;37;5;49;64;20;46;92;45;70;387;50;85
27.03.2023 12:00;157;288;37;11;48;42;17;42;67;28;77;78;32;80;445;48;90
27.03.2023 13:00;206;393;41;19;60;71;38;74;101;48;86;118;33;85;599;60;131
27.03.2023 14:00;171;358;43;13;84;79;14;42;94;29;75;120;29;103;529;56;163
27.03.2023 15:00;248;455;54;18;115;85;17;92;106;50;105;160;34;100;703;72;200
27.03.2023 16:00;294;528;93;37;140;112;36;112;150;52;139;214;64;134;822;130;252
27.03.2023 17:00;258;612;80;36;179;122;48;108;183;72;160;256;55;156;870;116;301
27.03.2023 18:00;223;473;52;19;117;95;40;75;121;30;92;238;36;112;696;71;212
27.03.2023 19:00;169;353;39;12;69;46;16;51;100;25;77;115;31;83;522;51;115
27.03.2023 20:00;126;201;15;10;38;14;4;31;29;18;44;63;17;25;327;25;52
27.03.2023 21:00;100;131;13;6;21;17;2;4;24;9;28;28;5;24;231;19;38
27.03.2023 22:00;95;145;10;4;24;9;2;3;25;4;20;12;1;16;240;14;33
27.03.2023 23:00;12;46;4;0;10;2;0;1;13;1;13;6;4;11;58;4;12
28.03.2023 00:00;4;11;2;3;1;1;1;0;4;2;7;1;1;1;15;5;2
28.03.2023 01:00;0;8;0;2;1;2;0;0;1;0;1;1;0;1;8;2;3
28.03.2023 02:00;3;9;0;0;0;0;0;1;2;0;1;0;0;1;12;0;0
28.03.2023 03:00;1;4;0;0;3;0;0;0;2;0;5;0;0;1;5;0;3
28.03.2023 04:00;4;10;5;0;3;0;1;0;1;0;5;3;1;0;14;5;3
28.03.2023 05:00;10;35;3;7;18;13;0;2;6;0;14;11;2;8;45;10;31
28.03.2023 06:00;32;108;31;23;36;35;15;26;29;14;38;43;14;32;140;54;71
28.03.2023 07:00;117;352;74;62;147;137;39;120;140;52;115;222;63;156;469;136;284
28.03.2023 08:00;0;391;75;35;228;199;33;161;195;55;114;370;51;170;391;110;427
28.03.2023 09:00;169;245;37;15;82;89;12;68;83;34;57;194;24;90;414;52;171
28.03.2023 10:00;72;206;29;13;39;45;17;43;66;16;36;76;41;82;278;42;84
28.03.2023 11:00;163;226;34;13;46;51;26;76;81;18;47;102;43;95;389;47;97
28.03.2023 12:00;97;268;42;16;55;56;30;70;103;25;55;98;47;111;365;58;111
28.03.2023 13:00;46;388;46;24;84;65;43;67;118;53;63;125;52;118;434;70;149
28.03.2023 14:00;35;336;46;23;98;70;38;80;111;30;57;148;51;125;371;69;168
28.03.2023 15:00;53;381;70;36;120;89;30;128;130;67;92;188;69;136;434;106;209
28.03.2023 16:00;0;497;98;55;155;128;50;121;167;50;92;237;88;164;497;153;283
28.03.2023 17:00;0;560;104;49;219;173;50;182;235;61;100;332;160;190;560;153;392
28.03.2023 18:00;0;493;67;47;151;113;39;132;164;44;86;266;75;166;493;114;264
28.03.2023 19:00;0;336;48;20;91;82;22;55;114;29;57;114;50;101;336;68;173
28.03.2023 20:00;0;206;17;7;41;27;9;40;35;17;31;58;9;33;206;24;68
28.03.2023 21:00;0;167;11;3;23;15;8;9;18;8;27;25;10;25;167;14;38
28.03.2023 22:00;57;164;3;4;10;11;2;6;13;5;21;8;4;9;221;7;21
28.03.2023 23:00;0;41;6;5;10;3;1;2;5;5;18;6;3;5;41;11;13
29.03.2023 00:00;5;14;0;1;1;4;2;1;1;1;2;2;0;0;19;1;5
29.03.2023 01:00;0;12;0;1;2;0;0;0;0;0;1;0;0;0;12;1;2
29.03.2023 02:00;2;6;0;0;0;0;0;1;2;0;1;0;0;0;8;0;0
29.03.2023 03:00;0;2;0;1;3;0;0;0;1;0;2;0;0;0;2;1;3
29.03.2023 04:00;0;10;3;0;3;1;1;0;1;0;5;3;2;0;10;3;4
29.03.2023 05:00;0;40;7;7;17;11;2;5;7;3;12;13;5;10;40;14;28
29.03.2023 06:00;0;105;22;39;52;41;17;29;31;10;46;56;18;30;105;61;93
29.03.2023 07:00;0;321;74;63;151;167;53;129;156;51;108;210;70;173;321;137;318
29.03.2023 08:00;0;404;81;43;226;207;46;127;223;55;111;365;51;180;404;124;433
29.03.2023 09:00;0;229;30;20;82;85;19;67;77;29;69;186;35;85;229;50;167
29.03.2023 10:00;0;194;25;14;59;50;24;49;72;23;38;107;43;81;194;39;109
29.03.2023 11:00;0;188;26;21;60;55;30;66;92;34;36;115;60;102;188;47;115
29.03.2023 12:00;0;276;47;26;75;64;29;73;101;35;71;111;39;107;276;73;139
29.03.2023 13:00;32;348;52;17;76;61;38;87;83;44;72;158;63;96;380;69;137
29.03.2023 14:00;0;351;44;36;96;72;38;91;143;37;84;141;72;131;351;80;168
29.03.2023 15:00;0;391;76;35;137;126;39;141;171;74;79;184;94;158;391;111;263
29.03.2023 16:00;58;522;101;56;188;146;67;144;229;59;136;267;90;238;580;157;334
29.03.2023 17:00;72;612;99;47;193;139;46;142;276;63;101;356;84;230;684;146;332
29.03.2023 18:00;119;461;80;39;150;108;40;144;190;47;76;251;91;157;580;119;258
29.03.2023 19:00;0;342;39;24;82;53;20;77;117;36;58;153;70;129;342;63;135
29.03.2023 20:00;0;192;26;9;52;30;13;27;64;16;34;91;23;57;192;35;82
29.03.2023 21:00;71;189;9;3;35;15;1;14;26;21;26;45;8;30;260;12;50
29.03.2023 22:00;96;147;8;10;28;10;1;6;24;11;22;31;4;25;243;18;38
29.03.2023 23:00;36;66;8;2;13;9;1;9;15;5;13;17;2;7;102;10;22
30.03.2023 00:00;11;29;0;2;6;3;1;0;6;0;6;4;1;7;40;2;9
30.03.2023 01:00;3;9;1;1;1;0;0;0;1;2;4;4;0;2;12;2;1
30.03.2023 02:00;3;6;0;0;0;1;0;0;1;0;1;0;0;0;9;0;1
30.03.2023 03:00;0;4;1;2;3;0;3;2;1;0;0;1;0;0;4;3;3
30.03.2023 04:00;1;9;1;2;5;1;1;1;1;1;5;1;2;0;10;3;6
30.03.2023 05:00;10;29;8;10;8;10;1;5;10;3;13;9;5;11;39;18;18
30.03.2023 06:00;13;99;29;27;56;36;15;35;27;7;42;43;28;26;112;56;92
30.03.2023 07:00;123;316;73;63;140;148;44;92;135;60;88;203;58;135;439;136;288
30.03.2023 08:00;183;389;70;35;208;184;46;140;177;56;93;322;55;175;572;105;392
30.03.2023 09:00;0;243;34;18;95;82;11;57;89;28;63;150;32;97;243;52;177
30.03.2023 10:00;40;180;27;14;43;54;35;64;70;28;48;81;53;61;220;41;97
30.03.2023 11:00;75;221;18;18;46;44;13;49;77;28;25;97;32;73;296;36;90
30.03.2023 12:00;46;207;29;8;44;25;6;34;35;14;42;68;26;36;253;37;69
30.03.2023 13:00;0;280;35;11;48;59;16;38;62;32;54;91;19;67;280;46;107
30.03.2023 14:00;51;328;35;21;82;65;16;41;90;36;48;124;26;93;379;56;147
30.03.2023 15:00;37;380;57;24;106;80;24;78;118;38;82;166;39;109;417;81;186
30.03.2023 16:00;51;482;75;29;154;111;25;99;148;37;84;180;59;145;533;104;265
30.03.2023 17:00;56;533;85;29;139;131;46;117;237;55;86;258;58;183;589;114;270
30.03.2023 18:00;57;447;53;29;142;120;41;115;188;62;70;237;67;187;504;82;262
30.03.2023 19:00;0;350;46;34;85;59;32;73;117;40;55;149;36;101;350;80;144
30.03.2023 20:00;0;235;17;12;43;27;10;44;58;26;27;69;28;56;235;29;70
30.03.2023 21:00;0;146;12;6;18;23;4;20;36;8;28;42;19;36;146;18;41
30.03.2023 22:00;0;145;6;5;24;13;1;14;19;16;23;32;9;20;145;11;37
30.03.2023 23:00;0;74;5;3;2;6;0;1;11;1;13;9;7;15;74;8;8
31.03.2023 00:00;0;23;1;1;5;6;0;3;8;0;9;4;4;3;23;2;11
31.03.2023 01:00;0;13;0;1;1;0;0;0;0;0;1;4;0;0;13;1;1
31.03.2023 02:00;0;9;1;1;2;2;0;1;2;0;5;2;0;0;9;2;4
31.03.2023 03:00;0;7;1;0;2;0;0;1;1;0;1;0;1;0;7;1;2
31.03.2023 04:00;0;7;1;1;3;3;1;0;1;0;2;3;1;0;7;2;6
31.03.2023 05:00;0;28;4;5;9;6;2;5;5;2;12;9;0;8;28;9;15
31.03.2023 06:00;0;69;15;12;29;25;8;18;30;2;33;23;19;21;69;27;54
31.03.2023 07:00;0;232;49;38;79;88;25;55;92;30;68;99;26;115;232;87;167
31.03.2023 08:00;0;244;44;17;103;94;17;57;85;31;84;180;32;85;244;61;197
31.03.2023 09:00;0;220;23;11;64;59;6;47;74;18;43;101;23;101;220;34;123
31.03.2023 10:00;0;197;24;11;26;28;15;32;50;29;47;72;23;80;197;35;54
31.03.2023 11:00;0;241;25;8;30;31;14;37;52;16;43;69;24;53;241;33;61
31.03.2023 12:00;0;266;38;20;42;43;13;41;64;34;61;73;23;60;266;58;85
31.03.2023 13:00;0;297;46;22;48;46;14;50;59;40;75;82;32;60;297;68;94
31.03.2023 14:00;0;280;24;12;63;50;22;54;64;29;64;81;30;55;280;36;113
31.03.2023 15:00;0;341;40;22;73;63;23;69;98;30;56;86;36;84;341;62;136
31.03.2023 16:00;0;286;33;30;73;68;26;72;108;33;64;139;37;90;286;63;141
31.03.2023 17:00;0;350;29;20;85;61;22;67;101;29;67;130;48;94;350;49;146
31.03.2023 18:00;0;308;26;12;55;59;21;52;87;38;39;115;27;67;308;38;114
31.03.2023 19:00;0;245;34;13;47;39;9;34;69;16;27;57;22;55;245;47;86
31.03.2023 20:00;0;187;11;2;33;16;5;32;30;3;35;51;8;25;187;13;49
31.03.2023 21:00;0;144;10;3;19;10;0;13;12;8;14;15;5;16;144;13;29
31.03.2023 22:00;0;140;4;1;7;8;0;6;10;6;19;16;4;11;140;5;15
31.03.2023 23:00;0;104;4;1;5;5;1;6;11;2;10;12;1;11;104;5;10
01.04.2023 00:00;0;83;4;1;8;6;0;2;12;3;11;6;1;7;83;5;14
01.04.2023 01:00;0;57;2;1;6;0;4;2;5;1;7;7;1;2;57;3;6
01.04.2023 02:00;0;47;2;0;3;4;1;2;2;0;5;8;1;0;47;2;7
01.04.2023 03:00;0;25;3;0;2;0;0;0;0;0;0;1;0;0;25;3;2
01.04.2023 04:00;0;13;0;1;1;0;1;1;1;0;4;4;1;1;13;1;1
01.04.2023 05:00;0;12;1;1;4;1;0;1;2;1;1;2;1;3;12;2;5
01.04.2023 06:00;0;14;1;1;6;2;2;1;4;2;7;2;1;5;14;2;8
01.04.2023 07:00;0;18;5;1;5;4;3;2;4;3;3;4;2;4;18;6;9
01.04.2023 08:00;0;51;17;4;13;15;4;8;18;1;9;18;9;17;51;21;28
01.04.2023 09:00;0;106;13;0;30;10;3;10;30;8;26;31;7;33;106;13;40
01.04.2023 10:00;0;132;11;4;20;11;5;20;25;13;21;20;14;22;132;15;31
01.04.2023 11:00;0;155;17;3;13;17;9;9;25;14;16;32;13;31;155;20;30
01.04.2023 12:00;0;175;11;8;17;25;16;26;42;22;30;42;15;36;175;19;42
01.04.2023 13:00;0;204;21;5;17;16;6;29;48;21;37;52;10;40;204;26;33
01.04.2023 14:00;0;183;23;4;26;16;15;28;32;14;19;57;23;23;183;27;42
01.04.2023 15:00;0;155;14;10;17;23;7;37;39;18;18;49;16;34;155;24;40
01.04.2023 16:00;0;166;14;5;23;26;9;23;51;21;22;70;18;42;166;19;49
01.04.2023 17:00;0;156;12;6;33;28;16;33;45;13;26;56;22;43;156;18;61
01.04.2023 18:00;0;174;15;4;25;14;9;25;26;14;21;41;17;18;174;19;39
01.04.2023 19:00;0;126;4;6;8;16;3;18;17;7;17;23;11;18;126;10;24
01.04.2023 20:00;0;90;7;2;8;6;2;11;3;9;15;28;7;6;90;9;14
01.04.2023 21:00;0;75;5;1;7;4;3;4;6;6;12;13;3;12;75;6;11
01.04.2023 22:00;0;74;1;4;6;6;0;0;7;1;5;6;2;7;74;5;12
01.04.2023 23:00;0;47;0;0;3;7;0;3;7;2;5;11;0;6;47;0;10
02.04.2023 00:00;0;36;2;0;7;2;0;0;8;0;3;2;1;9;36;2;9
02.04.2023 01:00;0;38;0;1;8;3;0;1;3;1;2;3;4;1;38;1;11
02.04.2023 02:00;0;21;1;0;1;0;0;2;2;0;1;2;4;1;21;1;1
02.04.2023 03:00;0;4;2;1;3;0;0;0;0;0;3;0;1;0;4;3;3
02.04.2023 04:00;0;11;0;0;4;0;0;3;1;0;1;3;0;1;11;0;4
02.04.2023 05:00;0;4;2;2;1;2;0;0;2;0;1;1;0;2;4;4;3
02.04.2023 06:00;0;8;0;0;3;3;0;3;5;2;0;2;2;6;8;0;6
02.04.2023 07:00;0;13;5;1;3;2;1;8;6;2;7;5;6;8;13;6;5
02.04.2023 08:00;0;38;13;3;11;13;2;8;16;4;6;13;6;15;38;16;24
02.04.2023 09:00;0;54;6;3;7;18;5;9;21;8;3;23;6;20;54;9;25
02.04.2023 10:00;0;100;24;22;20;17;11;51;38;8;13;42;43;28;100;46;37
02.04.2023 11:00;0;110;44;11;30;55;25;47;79;24;19;71;37;55;110;55;85
02.04.2023 12:00;0;121;29;17;38;39;33;98;60;24;18;77;66;60;121;46;77
02.04.2023 13:00;0;163;54;29;75;65;20;80;122;23;21;90;53;97;163;83;140
02.04.2023 14:00;0;196;43;25;63;47;39;131;144;33;43;194;115;114;196;68;110
02.04.2023 15:00;0;179;67;27;91;65;40;97;160;55;18;174;98;127;179;94;156
02.04.2023 16:00;0;177;42;29;61;67;35;93;139;60;23;157;87;136;177;71;128
02.04.2023 17:00;0;200;29;27;70;76;28;67;129;53;29;112;62;104;200;56;146
02.04.2023 18:00;0;171;31;14;49;52;16;73;96;39;19;97;55;88;171;45;101
02.04.2023 19:00;0;107;22;7;44;38;8;27;47;10;21;68;26;54;107;29;82
02.04.2023 20:00;0;104;8;5;16;14;6;22;23;7;19;36;11;16;104;13;30
02.04.2023 21:00;0;59;5;3;11;10;1;10;4;4;15;8;8;4;59;8;21
02.04.2023 22:00;0;38;2;0;1;4;3;4;7;1;12;4;0;7;38;2;5
02.04.2023 23:00;0;24;1;1;3;0;0;2;1;1;12;1;2;1;24;2;3
03.04.2023 00:00;0;11;2;1;3;1;0;0;2;0;1;1;0;1;11;3;4
03.04.2023 01:00;0;1;0;0;1;2;0;1;1;1;0;1;0;0;1;0;3
03.04.2023 02:00;0;1;0;0;0;1;0;0;0;1;0;0;0;0;1;0;1
03.04.2023 03:00;0;2;0;0;5;0;1;0;1;0;1;0;0;0;2;0;5
03.04.2023 04:00;0;11;3;4;2;3;0;1;5;0;7;6;1;3;11;7;5
03.04.2023 05:00;0;29;9;11;11;7;2;5;9;3;13;8;1;7;29;20;18
03.04.2023 06:00;0;87;24;25;56;34;14;28;37;11;48;47;26;28;87;49;90
03.04.2023 07:00;0;241;57;37;132;105;37;85;110;29;78;150;47;97;241;94;237
03.04.2023 08:00;0;354;61;26;196;161;50;128;169;57;86;320;48;145;354;87;357
03.04.2023 09:00;0;234;32;27;90;75;16;59;95;26;60;152;25;94;234;59;165
03.04.2023 10:00;0;191;35;23;38;45;18;75;62;24;32;93;46;81;191;58;83
03.04.2023 11:00;0;228;27;32;62;50;37;72;87;21;45;106;60;83;228;59;112
03.04.2023 12:00;0;275;48;21;63;67;39;104;109;46;52;153;76;123;275;69;130
03.04.2023 13:00;0;299;62;27;65;67;42;116;151;39;68;159;112;134;299;89;132
03.04.2023 14:00;0;316;53;30;83;103;43;228;199;74;68;190;143;186;316;83;186
03.04.2023 15:00;0;384;83;31;150;160;62;166;274;113;77;237;86;259;384;114;310
03.04.2023 16:00;0;546;101;41;168;137;63;176;248;71;89;264;106;197;546;142;305
03.04.2023 17:00;0;605;121;51;219;162;67;152;328;73;91;357;105;293;605;172;381
03.04.2023 18:00;0;537;82;56;158;123;55;133;259;59;98;258;85;261;537;138;281
03.04.2023 19:00;0;332;48;21;74;86;19;82;163;35;47;138;55;162;332;69;160
03.04.2023 20:00;0;223;26;17;35;28;11;41;62;13;29;81;22;56;223;43;63
03.04.2023 21:00;0;132;21;6;24;14;0;9;22;10;35;34;12;27;132;27;38
03.04.2023 22:00;0;105;6;3;15;13;1;2;14;9;34;16;2;11;105;9;28
03.04.2023 23:00;0;68;1;0;7;3;0;1;5;4;17;1;1;8;68;1;10
04.04.2023 00:00;0;21;0;1;0;3;3;0;0;1;4;3;0;0;21;1;3
04.04.2023 01:00;0;6;0;0;0;0;1;0;0;0;4;0;0;3;6;0;0
04.04.2023 02:00;0;2;0;0;1;0;0;0;1;0;0;0;0;0;2;0;1
04.04.2023 03:00;0;1;0;0;4;0;0;0;0;0;2;1;0;0;1;0;4
04.04.2023 04:00;0;10;5;4;2;1;1;1;3;0;2;4;1;3;10;9;3
04.04.2023 05:00;0;32;8;9;16;8;1;4;12;2;21;9;2;10;32;17;24
04.04.2023 06:00;0;86;35;29;49;33;11;25;25;7;50;49;18;17;86;64;82
04.04.2023 07:00;0;246;66;38;123;101;25;93;94;32;96;168;61;81;246;104;224
04.04.2023 08:00;0;369;72;26;208;197;33;138;198;51;82;384;40;165;369;98;405
04.04.2023 09:00;0;239;33;16;81;71;19;74;96;30;49;167;28;74;239;49;152
04.04.2023 10:00;0;220;26;15;50;42;19;53;53;24;47;111;46;46;220;41;92
04.04.2023 11:00;0;239;30;26;55;60;34;74;92;23;39;103;58;90;239;56;115
04.04.2023 12:00;0;257;36;21;72;51;38;77;102;33;46;139;60;83;257;57;123
04.04.2023 13:00;0;294;46;24;79;56;40;87;112;45;53;149;74;107;294;70;135
04.04.2023 14:00;0;349;45;36;95;77;38;115;176;51;55;168;88;150;349;81;172
04.04.2023 15:00;0;440;80;39;146;97;38;149;200;66;89;237;73;157;440;119;243
04.04.2023 16:00;211;547;96;45;182;161;65;147;282;62;105;270;110;198;758;141;343
04.04.2023 17:00;249;659;121;52;215;224;82;146;287;74;104;360;94;246;908;173;439
04.04.2023 18:00;259;520;62;45;168;105;50;133;233;55;74;282;92;217;779;107;273
04.04.2023 19:00;195;394;45;32;83;97;23;97;141;39;53;156;64;128;589;77;180
04.04.2023 20:00;107;207;27;11;47;33;7;27;57;21;23;64;18;49;314;38;80
04.04.2023 21:00;84;162;12;5;25;12;4;13;32;11;30;27;14;28;246;17;37
04.04.2023 22:00;65;121;6;3;23;14;1;4;12;10;29;18;5;13;186;9;37
04.04.2023 23:00;25;52;8;1;6;7;1;3;7;4;13;9;1;3;77;9;13
05.04.2023 00:00;7;18;1;1;3;1;1;2;3;1;3;1;0;3;25;2;4
05.04.2023 01:00;4;11;0;0;0;1;0;1;1;0;1;0;0;0;15;0;1
05.04.2023 02:00;0;6;0;2;0;0;0;0;0;1;4;2;1;0;6;2;0
05.04.2023 03:00;1;3;2;0;3;0;0;0;0;1;3;0;0;0;4;2;3
05.04.2023 04:00;6;11;3;1;2;1;0;1;4;0;3;6;2;3;17;4;3
05.04.2023 05:00;30;37;13;10;11;9;3;7;7;1;12;9;1;6;67;23;20
05.04.2023 06:00;88;98;29;29;49;31;16;22;29;8;40;44;24;20;186;58;80
05.04.2023 07:00;262;229;44;46;128;90;36;76;96;33;73;163;43;87;491;90;218
05.04.2023 08:00;350;350;47;31;199;176;23;133;161;36;89;324;73;140;700;78;375
05.04.2023 09:00;213;232;33;15;94;91;22;86;78;25;66;202;30;71;445;48;185
05.04.2023 10:00;162;221;20;12;52;45;10;51;70;23;35;96;51;70;383;32;97
05.04.2023 11:00;158;250;29;26;50;58;35;82;77;33;47;120;75;94;408;55;108
05.04.2023 12:00;153;275;36;16;85;62;29;90;139;37;56;189;86;121;428;52;147
05.04.2023 13:00;156;362;40;23;88;56;46;104;139;46;61;166;86;142;518;63;144
05.04.2023 14:00;162;381;55;22;81;108;50;119;180;40;67;215;93;162;543;77;189
05.04.2023 15:00;226;454;80;37;158;124;78;152;252;68;65;270;114;208;680;117;282
05.04.2023 16:00;270;520;82;51;196;162;78;193;311;58;90;284;102;251;790;133;358
05.04.2023 17:00;288;605;116;45;205;154;73;179;316;81;93;367;102;296;893;161;359
05.04.2023 18:00;251;534;88;50;194;127;57;120;273;58;71;281;81;240;785;138;321
05.04.2023 19:00;221;376;46;46;106;83;37;91;164;46;46;157;57;166;597;92;189
05.04.2023 20:00;146;229;22;20;42;31;14;30;75;26;55;89;13;84;375;42;73
05.04.2023 21:00;103;170;13;6;33;15;3;15;18;10;26;31;7;20;273;19;48
05.04.2023 22:00;81;123;6;2;21;7;1;6;14;8;34;35;5;15;204;8;28
05.04.2023 23:00;33;66;2;2;19;6;0;5;11;5;12;13;0;6;99;4;25
06.04.2023 00:00;20;32;3;0;6;7;0;1;7;0;4;1;0;5;52;3;13
06.04.2023 01:00;2;9;2;1;0;2;0;0;0;0;1;0;0;0;11;3;2
06.04.2023 02:00;0;5;0;0;6;0;0;0;0;0;2;0;0;0;5;0;6
06.04.2023 03:00;4;3;1;0;1;0;0;0;1;0;1;0;0;0;7;1;1
06.04.2023 04:00;7;10;3;1;4;1;1;1;2;0;3;5;0;2;17;4;5
06.04.2023 05:00;31;42;10;5;13;7;4;7;7;1;11;7;6;4;73;15;20
06.04.2023 06:00;78;75;26;17;35;30;8;18;26;3;34;30;13;18;153;43;65
06.04.2023 07:00;224;202;36;35;98;92;24;57;68;26;70;108;32;59;426;71;190
06.04.2023 08:00;309;300;53;23;152;137;27;83;127;28;73;256;41;119;609;76;289
06.04.2023 09:00;187;240;30;16;61;58;26;67;60;22;40;123;41;71;427;46;119
06.04.2023 10:00;156;213;19;15;45;31;20;63;56;29;43;95;67;77;369;34;76
06.04.2023 11:00;152;235;22;30;53;55;51;59;83;29;56;131;53;86;387;52;108
06.04.2023 12:00;164;258;42;19;86;55;31;99;109;41;59;145;66;105;422;61;141
06.04.2023 13:00;160;283;34;22;71;44;47;79;86;32;54;136;64;93;443;56;115
06.04.2023 14:00;84;330;40;20;72;62;38;90;100;27;69;131;55;92;414;60;134
06.04.2023 15:00;0;406;54;27;99;114;30;99;145;47;69;214;63;112;406;81;213
06.04.2023 16:00;52;427;58;14;116;70;55;77;118;37;89;190;44;94;479;72;186
06.04.2023 17:00;39;386;42;21;91;81;24;59;98;32;68;154;45;79;425;63;172
06.04.2023 18:00;33;297;15;13;49;45;11;40;61;27;42;90;22;53;330;28;94
06.04.2023 19:00;0;214;11;10;31;23;10;17;28;14;41;32;2;26;214;21;54
06.04.2023 20:00;0;133;9;3;19;13;4;10;21;8;23;19;1;27;133;12;32
06.04.2023 21:00;0;81;8;3;9;4;1;5;8;6;19;11;6;13;81;11;13
06.04.2023 22:00;0;86;2;0;5;10;2;6;8;3;6;13;2;6;86;2;15
06.04.2023 23:00;6;43;6;0;4;4;0;4;7;6;3;3;3;5;49;6;8
07.04.2023 00:00;0;27;3;1;3;2;0;1;1;0;5;3;3;1;27;4;5
07.04.2023 01:00;0;13;0;0;2;2;0;1;2;1;1;1;0;1;13;0;4
07.04.2023 02:00;0;15;0;0;1;0;0;0;2;0;0;3;1;1;15;0;1
07.04.2023 03:00;0;9;1;1;0;0;0;1;1;0;0;1;0;1;9;2;0
07.04.2023 04:00;0;2;1;0;1;0;0;1;0;0;3;0;0;0;2;1;1
07.04.2023 05:00;0;8;2;0;0;0;2;2;3;0;2;2;4;1;8;2;0
07.04.2023 06:00;0;2;2;1;3;2;0;2;3;1;4;1;1;2;2;3;5
07.04.2023 07:00;0;15;2;2;1;7;0;2;4;0;5;3;5;2;15;4;8
07.04.2023 08:00;0;26;5;0;4;7;3;4;6;1;10;11;2;2;26;5;11
07.04.2023 09:00;0;40;3;5;2;7;11;12;9;2;9;19;13;6;40;8;9
07.04.2023 10:00;0;82;16;5;11;18;13;9;21;3;11;27;11;26;82;21;29
07.04.2023 11:00;0;60;5;5;14;11;15;30;17;6;15;37;24;15;60;10;25
07.04.2023 12:00;0;61;19;6;15;14;19;33;51;5;14;35;29;33;61;25;29
07.04.2023 13:00;0;59;23;12;12;20;25;26;32;10;13;51;14;20;59;35;32
07.04.2023 14:00;0;69;16;4;21;12;18;30;31;12;20;46;26;26;69;20;33
07.04.2023 15:00;0;57;12;2;15;9;12;28;26;8;9;29;25;20;57;14;24
07.04.2023 16:00;0;63;10;7;9;12;20;26;47;7;9;54;22;26;63;17;21
07.04.2023 17:00;0;56;13;7;24;28;3;54;35;9;18;54;41;30;56;20;52
07.04.2023 18:00;0;101;13;5;10;23;8;42;24;7;7;41;31;21;101;18;33
07.04.2023 19:00;0;61;13;8;11;18;17;20;28;14;15;35;19;38;61;21;29
07.04.2023 20:00;0;61;6;2;16;18;2;10;21;5;8;24;3;19;61;8;34
07.04.2023 21:00;0;41;8;4;5;8;2;6;6;3;8;15;2;6;41;12;13
07.04.2023 22:00;0;34;2;2;5;3;0;2;5;0;13;7;5;10;34;4;8
07.04.2023 23:00;0;29;3;1;5;3;1;1;7;2;14;5;3;5;29;4;8
08.04.2023 00:00;0;14;0;0;4;5;0;0;2;2;7;0;1;2;14;0;9
08.04.2023 01:00;0;8;1;0;1;0;0;0;0;0;1;2;0;0;8;1;1
08.04.2023 02:00;0;5;1;0;1;0;0;0;0;1;2;1;0;1;5;1;1
08.04.2023 03:00;0;3;1;1;1;0;0;0;0;0;3;0;0;0;3;2;1
08.04.2023 04:00;0;1;1;0;1;1;0;0;0;0;4;1;1;0;1;1;2
08.04.2023 05:00;0;7;2;1;1;2;0;1;5;0;6;3;1;2;7;3;3
08.04.2023 06:00;0;16;4;1;5;1;3;2;3;0;5;3;1;3;16;5;6
08.04.2023 07:00;0;23;5;4;7;7;5;9;8;4;14;4;8;7;23;9;14
08.04.2023 08:00;0;59;11;6;17;7;8;9;21;16;20;21;16;16;59;17;24
08.04.2023 09:00;0;101;16;10;30;23;27;38;43;21;18;41;28;35;101;26;53
08.04.2023 10:00;0;188;24;19;28;27;34;79;77;28;32;87;72;70;188;43;55
08.04.2023 11:00;0;249;29;19;42;23;49;123;116;31;44;109;108;113;249;48;65
08.04.2023 12:00;0;252;50;23;62;49;71;105;142;51;59;152;115;125;252;73;111
08.04.2023 13:00;0;311;57;32;56;42;52;123;160;51;46;189;95;142;311;89;98
08.04.2023 14:00;0;262;66;29;58;79;84;129;198;64;49;163;104;179;262;95;137
08.04.2023 15:00;0;276;50;26;77;54;85;136;160;49;46;196;114;141;276;76;131
08.04.2023 16:00;26;216;52;26;69;75;55;117;192;59;40;166;88;167;242;78;144
08.04.2023 17:00;0;222;48;22;57;42;58;101;144;43;33;141;92;126;222;70;99
08.04.2023 18:00;0;227;31;16;58;42;32;71;117;28;31;97;63;114;227;47;100
08.04.2023 19:00;0;191;19;9;32;35;14;77;79;24;19;69;44;69;191;28;67
08.04.2023 20:00;0;85;19;6;12;16;12;31;32;12;15;48;19;36;85;25;28
08.04.2023 21:00;0;71;7;4;16;5;1;15;9;5;5;29;9;12;71;11;21
08.04.2023 22:00;0;73;8;0;3;6;0;9;8;2;7;23;4;4;73;8;9
08.04.2023 23:00;12;59;2;1;14;6;1;8;6;6;7;3;5;10;71;3;20
09.04.2023 00:00;0;41;0;0;5;6;0;9;7;1;5;5;1;6;41;0;11
09.04.2023 01:00;0;28;2;2;1;2;0;1;2;1;1;2;2;1;28;4;3
09.04.2023 02:00;0;16;2;0;1;1;3;0;2;1;0;5;0;3;16;2;2
09.04.2023 03:00;0;8;1;0;0;1;0;1;0;0;1;1;0;1;8;1;1
09.04.2023 04:00;0;6;1;0;1;2;0;1;1;0;2;2;0;2;6;1;3
09.04.2023 05:00;0;9;0;2;0;1;0;3;1;1;3;2;0;1;9;2;1
09.04.2023 06:00;0;9;1;2;7;4;0;4;7;1;3;4;4;6;9;3;11
09.04.2023 07:00;0;32;4;4;9;9;5;12;10;2;7;17;6;3;32;8;18
09.04.2023 08:00;5;40;15;5;16;6;7;17;18;4;12;12;21;15;45;20;22
09.04.2023 09:00;0;63;22;9;31;33;22;54;52;10;12;65;41;57;63;31;64
09.04.2023 10:00;0;83;42;22;54;46;52;97;105;19;24;81;88;103;83;64;100
09.04.2023 11:00;0;161;85;59;88;81;87;196;240;27;34;214;154;197;161;144;169
09.04.2023 12:00;0;191;124;51;132;86;102;235;306;41;37;278;203;252;191;175;218
09.04.2023 13:00;0;221;106;40;139;113;148;261;324;58;40;315;260;275;221;146;252
09.04.2023 14:00;0;211;79;63;144;123;129;266;337;64;49;330;205;223;211;142;267
09.04.2023 15:00;0;218;60;67;113;94;120;219;259;76;29;251;181;246;218;127;207
09.04.2023 16:00;0;190;75;51;110;63;95;196;235;48;21;259;169;204;190;126;173
09.04.2023 17:00;0;169;50;38;104;77;81;158;225;58;33;192;106;197;169;88;181
09.04.2023 18:00;0;177;89;34;84;73;65;113;215;59;25;146;83;195;177;123;157
09.04.2023 19:00;0;139;41;29;54;68;31;56;117;33;20;79;36;122;139;70;122
09.04.2023 20:00;0;97;22;16;34;36;24;30;55;20;17;57;22;48;97;38;70
09.04.2023 21:00;0;49;16;12;5;16;5;22;31;9;7;29;15;20;49;28;21
09.04.2023 22:00;8;45;5;6;6;2;1;5;12;8;9;9;7;12;53;11;8
09.04.2023 23:00;13;34;4;2;2;3;3;4;4;2;8;2;3;8;47;6;5
10.04.2023 00:00;0;16;2;3;1;4;2;3;4;4;2;1;1;4;16;5;5
10.04.2023 01:00;0;21;0;1;3;0;0;0;2;0;2;1;0;2;21;1;3
10.04.2023 02:00;0;2;0;2;2;0;0;0;2;0;4;1;2;0;2;2;2
10.04.2023 03:00;0;7;1;0;0;1;0;0;0;0;0;2;0;1;7;1;1
10.04.2023 04:00;0;1;1;1;0;0;0;1;2;0;3;1;0;0;1;2;0
10.04.2023 05:00;0;6;0;2;1;5;0;2;3;2;3;2;1;2;6;2;6
10.04.2023 06:00;0;11;5;3;5;3;3;3;5;2;0;5;5;6;11;8;8
10.04.2023 07:00;0;16;11;4;8;9;11;7;8;1;3;10;7;2;16;15;17
10.04.2023 08:00;25;41;16;9;19;22;11;25;38;10;7;40;26;25;66;25;41
10.04.2023 09:00;59;87;41;21;54;31;36;55;106;19;17;73;59;83;146;62;85
10.04.2023 10:00;37;134;79;53;75;65;80;126;163;48;33;159;103;121;171;132;140
10.04.2023 11:00;68;175;99;72;105;95;105;246;238;52;32;274;179;235;243;171;200
10.04.2023 12:00;160;246;123;71;114;107;154;267;359;83;41;288;235;289;406;194;221
10.04.2023 13:00;121;232;149;90;169;133;177;316;384;74;42;347;272;318;353;239;302
10.04.2023 14:00;0;287;129;67;157;147;158;315;378;101;64;333;238;303;287;196;304
10.04.2023 15:00;0;228;111;55;143;125;124;239;402;69;36;328;207;316;228;166;268
10.04.2023 16:00;0;242;79;76;169;123;131;257;333;67;41;266;172;312;242;155;292
10.04.2023 17:00;0;210;85;34;128;105;71;195;276;49;42;286;140;206;210;119;233
10.04.2023 18:00;0;170;46;28;54;57;41;118;110;30;39;142;107;118;170;74;111
10.04.2023 19:00;0;117;19;12;43;28;9;51;43;18;17;87;38;44;117;31;71
10.04.2023 20:00;0;73;11;1;19;15;4;21;17;3;24;28;11;23;73;12;34
10.04.2023 21:00;0;71;7;1;8;6;0;11;11;7;13;13;3;15;71;8;14
10.04.2023 22:00;0;32;3;1;2;2;0;1;6;2;6;7;1;4;32;4;4
10.04.2023 23:00;0;19;0;0;6;1;0;1;6;1;1;0;0;4;19;0;7
11.04.2023 00:00;0;8;1;0;1;2;0;2;0;3;0;1;0;1;8;1;3
11.04.2023 01:00;0;8;0;0;1;0;0;0;0;0;0;1;0;0;8;0;1
11.04.2023 02:00;0;3;0;0;2;0;0;1;0;1;2;1;1;0;3;0;2
11.04.2023 03:00;0;0;1;0;1;0;0;0;0;0;1;1;0;0;0;1;1
11.04.2023 04:00;0;7;3;1;1;2;1;1;1;0;1;5;0;1;7;4;3
11.04.2023 05:00;0;34;15;5;22;8;1;6;10;4;16;9;5;10;34;20;30
11.04.2023 06:00;0;110;39;29;74;33;19;27;32;6;34;48;23;28;110;68;107
11.04.2023 07:00;0;224;62;34;121;110;37;88;98;28;81;163;49;76;224;96;231
11.04.2023 08:00;0;335;59;19;158;158;35;108;156;36;72;254;54;108;335;78;316
11.04.2023 09:00;0;209;25;21;50;73;30;63;82;29;50;133;30;64;209;46;123
11.04.2023 10:00;0;233;22;23;51;35;34;80;59;22;33;112;48;55;233;45;86
11.04.2023 11:00;0;224;29;18;45;49;31;85;94;27;51;123;58;64;224;47;94
11.04.2023 12:00;0;260;25;21;57;57;41;88;102;39;50;134;68;86;260;46;114
11.04.2023 13:00;0;271;38;18;83;60;37;83;117;33;49;123;77;86;271;56;143
11.04.2023 14:00;173;301;53;16;87;83;53;97;166;35;58;146;78;131;474;69;170
11.04.2023 15:00;200;415;78;32;131;103;67;135;192;41;72;225;90;142;615;110;234
11.04.2023 16:00;276;506;90;49;173;106;75;137;233;66;111;265;118;206;782;139;279
11.04.2023 17:00;303;603;82;77;194;176;71;176;270;59;94;324;111;224;906;159;370
11.04.2023 18:00;0;510;65;37;115;128;45;148;170;59;78;239;99;201;510;102;243
11.04.2023 19:00;0;321;67;22;64;53;17;75;104;41;48;126;54;116;321;89;117
11.04.2023 20:00;0;222;28;12;22;26;9;35;54;14;40;59;21;75;222;40;48
11.04.2023 21:00;0;139;16;3;22;11;3;19;26;8;37;31;12;35;139;19;33
11.04.2023 22:00;0;111;5;6;20;8;3;8;13;7;20;12;3;8;111;11;28
11.04.2023 23:00;0;54;3;2;7;8;2;0;6;2;17;8;6;8;54;5;15
12.04.2023 00:00;0;18;3;1;2;6;0;0;2;2;7;2;3;1;18;4;8
12.04.2023 01:00;0;11;1;0;4;1;0;3;0;0;1;3;3;1;11;1;5
12.04.2023 02:00;0;3;0;0;1;5;3;0;0;1;1;0;0;0;3;0;6
12.04.2023 03:00;0;3;2;0;8;0;0;1;4;0;2;12;0;2;3;2;8
12.04.2023 04:00;0;6;1;0;3;1;0;1;0;1;4;5;1;0;6;1;4
12.04.2023 05:00;0;21;4;4;17;6;2;4;4;0;19;5;3;5;21;8;23
12.04.2023 06:00;0;84;24;6;41;22;10;12;15;5;36;24;11;11;84;30;63
12.04.2023 07:00;0;144;38;19;72;50;13;40;40;15;43;66;29;40;144;57;122
12.04.2023 08:00;0;168;33;11;79;73;16;38;65;15;40;133;22;56;168;44;152
12.04.2023 09:00;0;114;11;5;22;39;3;29;29;6;20;64;17;24;114;16;61
12.04.2023 10:00;0;97;4;9;18;16;10;21;27;9;15;42;11;33;97;13;34
12.04.2023 11:00;0;111;11;2;10;12;10;23;31;18;23;43;16;32;111;13;22
12.04.2023 12:00;0;177;19;5;27;17;11;25;24;15;27;58;19;27;177;24;44
12.04.2023 13:00;0;135;18;11;27;17;17;20;26;9;26;36;28;20;135;29;44
12.04.2023 14:00;0;164;24;13;30;42;14;39;38;19;39;60;26;50;164;37;72
12.04.2023 15:00;0;221;16;10;66;50;17;53;69;34;41;77;33;52;221;26;116
12.04.2023 16:00;0;294;51;27;84;72;35;73;116;34;57;135;44;107;294;78;156
12.04.2023 17:00;0;352;38;24;91;64;21;75;112;26;52;153;63;91;352;62;155
12.04.2023 18:00;0;312;32;16;58;55;20;45;78;28;48;96;40;82;312;48;113
12.04.2023 19:00;0;250;15;6;44;28;9;33;41;17;45;64;13;60;250;21;72
12.04.2023 20:00;0;161;15;8;27;11;7;18;37;11;19;42;21;44;161;23;38
12.04.2023 21:00;0;124;9;2;19;15;4;8;19;7;8;29;7;32;124;11;34
12.04.2023 22:00;0;103;7;4;15;17;3;5;8;9;28;13;1;7;103;11;32
12.04.2023 23:00;0;44;1;2;6;3;0;7;3;0;6;4;1;3;44;3;9
13.04.2023 00:00;0;20;2;0;1;3;0;0;2;1;1;5;0;1;20;2;4
13.04.2023 01:00;0;10;1;0;1;0;0;0;0;0;1;1;0;0;10;1;1
13.04.2023 02:00;0;2;1;0;2;0;0;2;0;0;1;1;1;0;2;1;2
13.04.2023 03:00;0;3;0;0;2;0;0;0;1;0;1;0;0;0;3;0;2
13.04.2023 04:00;0;9;1;0;4;1;0;0;2;0;5;2;2;2;9;1;5
13.04.2023 05:00;0;25;5;9;23;9;0;5;12;1;15;5;1;9;25;14;32
13.04.2023 06:00;0;85;34;20;62;44;15;29;32;5;33;48;25;27;85;54;106
13.04.2023 07:00;0;212;52;32;111;104;31;71;89;24;66;133;42;69;212;84;215
13.04.2023 08:00;0;287;53;22;153;141;31;107;133;35;56;248;55;103;287;75;294
13.04.2023 09:00;0;193;20;24;55;70;18;61;70;15;41;135;25;56;193;44;125
13.04.2023 10:00;0;154;17;18;22;26;18;54;45;15;44;67;41;42;154;35;48
13.04.2023 11:00;0;189;17;13;44;24;41;44;49;18;29;96;36;47;189;30;68
13.04.2023 12:00;31;225;41;15;53;53;25;40;83;26;52;80;39;73;256;56;106
13.04.2023 13:00;0;275;28;17;54;45;17;61;78;27;42;109;54;67;275;45;99
13.04.2023 14:00;0;256;27;16;69;53;35;81;103;38;49;140;54;87;256;43;122
13.04.2023 15:00;0;341;53;32;145;82;27;91;168;52;68;134;73;137;341;85;227
13.04.2023 16:00;0;444;72;29;163;107;46;135;178;52;73;243;91;158;444;101;270
13.04.2023 17:00;0;587;82;48;180;177;40;154;300;69;98;321;98;245;587;130;357
13.04.2023 18:00;0;456;75;29;151;137;57;125;195;50;70;262;94;187;456;104;288
13.04.2023 19:00;0;327;38;23;98;102;22;94;83;35;67;166;58;128;327;61;200
13.04.2023 20:00;0;235;22;17;40;69;20;39;99;34;37;102;49;122;235;39;109
13.04.2023 21:00;0;147;12;11;22;10;6;22;24;7;23;40;15;26;147;23;32
13.04.2023 22:00;0;110;8;3;9;7;3;12;5;5;21;16;5;9;110;11;16
13.04.2023 23:00;0;74;4;0;11;9;1;2;11;3;8;9;3;3;74;4;20
14.04.2023 00:00;0;39;0;0;4;3;0;1;3;1;3;3;2;1;39;0;7
14.04.2023 01:00;0;15;1;1;3;0;0;1;2;0;0;4;0;2;15;2;3
14.04.2023 02:00;0;8;0;0;3;3;0;2;2;1;0;1;2;1;8;0;6
14.04.2023 03:00;0;5;3;0;2;1;0;0;1;0;3;0;0;1;5;3;3
14.04.2023 04:00;0;8;2;0;4;2;1;0;0;0;4;4;1;0;8;2;6
14.04.2023 05:00;0;35;6;8;13;9;2;6;7;3;13;8;6;8;35;14;22
14.04.2023 06:00;0;84;25;20;48;29;9;25;31;6;38;42;17;25;84;45;77
14.04.2023 07:00;0;218;50;22;100;82;28;66;88;24;67;110;35;79;218;72;182
14.04.2023 08:00;0;288;46;22;108;91;31;75;115;40;64;232;42;111;288;68;199
14.04.2023 09:00;0;236;23;18;64;65;24;56;84;25;54;145;33;72;236;41;129
14.04.2023 10:00;0;218;35;31;81;55;61;78;121;34;51;147;79;123;218;66;136
14.04.2023 11:00;0;292;55;38;93;59;75;180;178;31;52;218;119;165;292;93;152
14.04.2023 12:00;55;349;81;26;98;71;97;184;189;61;61;267;173;189;404;107;169
14.04.2023 13:00;0;397;81;56;109;82;115;203;241;43;70;305;170;219;397;137;191
14.04.2023 14:00;0;510;103;64;163;133;134;239;326;69;100;318;210;279;510;167;296
14.04.2023 15:00;0;542;108;82;192;135;121;257;298;76;76;331;191;296;542;190;327
14.04.2023 16:00;0;481;105;46;214;170;137;291;340;67;93;405;208;335;481;151;384
14.04.2023 17:00;0;542;92;56;153;168;103;236;379;81;82;381;156;295;542;148;321
14.04.2023 18:00;116;498;83;36;108;136;69;160;237;66;64;241;107;258;614;119;244
14.04.2023 19:00;90;390;61;30;79;86;41;104;219;52;44;171;58;223;480;91;165
14.04.2023 20:00;56;241;38;21;46;48;24;74;78;26;31;98;39;123;297;59;94
14.04.2023 21:00;28;164;10;11;27;31;2;22;36;27;19;30;13;51;192;21;58
14.04.2023 22:00;14;139;13;1;11;6;4;22;22;11;14;31;11;25;153;14;17
14.04.2023 23:00;33;104;2;7;16;10;2;3;14;10;14;32;4;16;137;9;26
15.04.2023 00:00;0;78;5;2;5;9;4;12;19;1;11;13;4;25;78;7;14
15.04.2023 01:00;2;46;1;3;2;4;0;2;5;3;3;11;1;3;48;4;6
15.04.2023 02:00;0;34;0;2;4;1;4;1;0;0;4;4;0;7;34;2;5
15.04.2023 03:00;2;15;0;2;1;0;0;0;0;0;5;2;0;8;17;2;1
15.04.2023 04:00;6;9;3;1;2;2;1;2;0;1;3;6;0;0;15;4;4
15.04.2023 05:00;4;19;1;0;5;5;0;2;4;0;9;2;1;3;23;1;10
15.04.2023 06:00;20;24;6;6;12;11;3;6;6;1;5;8;2;2;44;12;23
15.04.2023 07:00;19;40;6;3;20;25;6;23;23;3;7;21;11;28;59;9;45
15.04.2023 08:00;63;68;17;9;37;47;9;27;55;15;25;84;16;44;131;26;84
15.04.2023 09:00;143;136;29;22;61;92;29;68;100;31;44;154;40;84;279;51;153
15.04.2023 10:00;137;222;34;34;111;148;31;112;178;40;60;243;89;137;359;68;259
15.04.2023 11:00;165;284;76;22;138;149;88;113;211;63;49;332;104;169;449;98;287
15.04.2023 12:00;127;379;65;41;147;200;88;201;273;68;70;350;153;245;506;106;347
15.04.2023 13:00;0;341;57;35;125;186;82;203;264;61;71;405;149;216;341;92;311
15.04.2023 14:00;62;408;76;35;154;157;73;156;274;62;79;382;113;221;470;111;311
15.04.2023 15:00;144;342;62;28;102;116;59;110;188;32;56;270;85;154;486;90;218
15.04.2023 16:00;145;272;36;28;56;55;39;55;111;28;68;138;54;106;417;64;111
15.04.2023 17:00;107;250;26;10;47;32;39;56;70;27;39;96;38;69;357;36;79
15.04.2023 18:00;116;210;21;2;10;28;11;26;51;19;33;52;19;52;326;23;38
15.04.2023 19:00;106;152;10;5;16;10;3;13;16;21;21;28;15;21;258;15;26
15.04.2023 20:00;67;104;6;5;5;6;4;22;20;7;7;20;11;10;171;11;11
15.04.2023 21:00;40;61;5;1;8;11;0;8;11;7;12;13;3;16;101;6;19
15.04.2023 22:00;43;83;3;3;4;6;0;2;2;3;12;7;0;5;126;6;10
15.04.2023 23:00;29;72;5;1;9;1;1;4;9;0;10;12;6;12;101;6;10
16.04.2023 00:00;31;45;2;0;3;4;1;3;13;0;5;8;1;4;76;2;7
16.04.2023 01:00;12;41;0;0;0;6;0;4;11;2;3;4;2;2;53;0;6
16.04.2023 02:00;17;24;6;0;3;5;0;2;4;2;9;2;0;9;41;6;8
16.04.2023 03:00;5;9;2;2;1;0;2;0;0;0;3;2;1;0;14;4;1
16.04.2023 04:00;4;21;0;0;2;0;1;1;0;0;1;4;0;2;25;0;2
16.04.2023 05:00;0;8;1;2;4;1;0;5;3;0;1;1;3;3;8;3;5
16.04.2023 06:00;0;6;2;1;3;2;1;5;5;2;8;6;2;4;6;3;5
16.04.2023 07:00;3;17;7;2;13;6;3;5;14;1;8;8;4;17;20;9;19
16.04.2023 08:00;17;48;11;5;15;11;8;20;20;8;5;13;20;15;65;16;26
16.04.2023 09:00;0;65;28;10;24;19;20;25;35;9;13;32;28;38;65;38;43
16.04.2023 10:00;0;89;31;13;61;36;20;67;77;17;12;87;40;51;89;44;97
16.04.2023 11:00;73;98;28;23;38;39;17;57;66;19;22;87;38;65;171;51;77
16.04.2023 12:00;141;153;46;28;44;44;51;94;108;19;23;95;79;104;294;74;88
16.04.2023 13:00;120;180;44;27;58;71;68;82;120;25;39;135;78;105;300;71;129
16.04.2023 14:00;87;264;78;28;48;61;57;104;168;44;38;167;73;136;351;106;109
16.04.2023 15:00;32;252;69;25;69;100;63;109;207;47;29;199;112;157;284;94;169
16.04.2023 16:00;43;228;48;33;68;85;43;142;162;29;24;184;76;173;271;81;153
16.04.2023 17:00;0;259;55;14;63;72;49;104;185;48;29;139;90;146;259;69;135
16.04.2023 18:00;39;233;43;16;37;61;31;83;99;32;22;114;68;99;272;59;98
16.04.2023 19:00;0;170;29;13;24;30;18;35;85;29;23;70;28;83;170;42;54
16.04.2023 20:00;0;99;14;6;27;22;6;21;35;9;13;38;17;51;99;20;49
16.04.2023 21:00;0;70;10;3;10;10;0;16;11;0;8;20;7;12;70;13;20
16.04.2023 22:00;12;50;3;2;12;2;1;4;1;5;12;6;2;5;62;5;14
16.04.2023 23:00;0;18;1;0;6;0;0;5;4;1;15;8;1;3;18;1;6
17.04.2023 00:00;0;7;1;0;3;1;0;0;4;1;1;0;0;1;7;1;4
17.04.2023 01:00;0;5;5;1;2;0;0;1;0;0;0;0;0;0;5;6;2
17.04.2023 02:00;0;3;0;0;1;0;0;0;2;0;3;0;0;0;3;0;1
17.04.2023 03:00;0;2;0;2;3;0;0;0;1;0;4;0;0;0;2;2;3
17.04.2023 04:00;0;11;3;1;5;0;1;0;1;1;6;4;1;0;11;4;5
17.04.2023 05:00;0;36;14;8;9;9;5;9;13;2;25;12;5;11;36;22;18
17.04.2023 06:00;0;126;33;36;59;43;21;32;50;10;48;61;28;40;126;69;102
17.04.2023 07:00;0;343;93;70;162;156;55;122;165;55;130;203;60;167;343;163;318
17.04.2023 08:00;0;374;67;35;200;176;36;132;174;49;113;327;38;143;374;102;376
17.04.2023 09:00;0;256;32;28;81;70;31;56;91;20;73;128;21;79;256;60;151
17.04.2023 10:00;0;196;29;20;45;42;19;33;58;28;36;70;19;70;196;49;87
17.04.2023 11:00;0;218;42;16;42;54;30;60;86;21;51;76;45;84;218;58;96
17.04.2023 12:00;0;237;25;9;65;55;24;51;94;39;50;99;53;102;237;34;120
17.04.2023 13:00;0;345;43;33;81;58;38;77;138;56;58;138;66;135;345;76;139
17.04.2023 14:00;46;365;60;23;93;96;51;85;157;56;60;169;67;178;411;83;189
17.04.2023 15:00;0;431;88;36;136;93;38;134;183;68;102;197;101;176;431;124;229
17.04.2023 16:00;0;559;118;55;148;123;60;138;224;80;129;267;87;227;559;173;271
17.04.2023 17:00;0;628;113;45;193;152;71;139;264;73;118;291;83;253;628;158;345
17.04.2023 18:00;0;559;83;41;146;135;48;99;227;47;91;281;86;202;559;124;281
17.04.2023 19:00;0;363;50;36;99;80;25;76;136;39;48;168;66;153;363;86;179
17.04.2023 20:00;0;246;22;24;39;36;23;42;58;23;33;87;24;76;246;46;75
17.04.2023 21:00;0;168;18;13;28;13;4;14;43;12;29;36;15;52;168;31;41
17.04.2023 22:00;0;121;10;4;20;11;2;4;15;9;23;11;4;13;121;14;31
17.04.2023 23:00;0;45;3;4;3;5;0;1;6;2;16;6;3;5;45;7;8
18.04.2023 00:00;0;19;3;1;2;3;1;1;3;0;5;3;1;3;19;4;5
18.04.2023 01:00;0;5;2;1;1;1;0;0;0;0;0;1;0;1;5;3;2
18.04.2023 02:00;0;3;0;0;3;0;0;0;0;0;4;0;0;0;3;0;3
18.04.2023 03:00;0;6;0;1;1;0;0;1;2;0;2;0;1;0;6;1;1
18.04.2023 04:00;0;9;3;2;6;2;0;2;2;1;13;4;2;1;9;5;8
18.04.2023 05:00;0;34;16;12;23;12;6;10;9;1;22;18;7;9;34;28;35
18.04.2023 06:00;0;125;41;48;79;47;21;55;54;8;55;73;38;44;125;89;126
18.04.2023 07:00;0;439;116;74;183;198;61;140;205;67;144;303;89;221;439;190;381
18.04.2023 08:00;0;509;105;52;313;243;56;246;277;48;138;452;78;246;509;157;556
18.04.2023 09:00;0;263;39;26;123;108;34;95;103;31;65;197;41;95;263;65;231
18.04.2023 10:00;0;229;34;30;55;56;27;70;89;30;37;130;65;75;229;64;111
18.04.2023 11:00;0;271;38;22;71;47;40;92;125;34;57;147;59;114;271;60;118
18.04.2023 12:00;0;306;48;22;79;48;35;71;98;25;63;139;62;114;306;70;127
18.04.2023 13:00;0;404;63;25;97;89;36;111;149;48;61;163;82;167;404;88;186
18.04.2023 14:00;0;366;72;34;105;106;65;92;150;45;78;194;83;140;366;106;211
18.04.2023 15:00;0;447;108;37;159;118;77;148;195;63;92;242;81;188;447;145;277
18.04.2023 16:00;0;612;137;60;221;163;58;205;273;88;143;325;107;227;612;197;384
18.04.2023 17:00;0;685;131;96;277;230;84;186;326;102;124;429;149;340;685;227;507
18.04.2023 18:00;0;617;135;61;203;193;65;174;301;92;97;373;103;308;617;196;396
18.04.2023 19:00;0;425;75;57;97;122;42;113;180;48;88;192;82;188;425;132;219
18.04.2023 20:00;0;265;43;23;66;54;13;61;115;37;54;134;31;131;265;66;120
18.04.2023 21:00;0;205;23;16;41;25;11;26;37;15;34;73;20;65;205;39;66
18.04.2023 22:00;0;156;6;6;35;16;2;12;28;8;44;30;9;23;156;12;51
18.04.2023 23:00;0;68;1;1;7;7;0;3;9;7;11;6;4;8;68;2;14
19.04.2023 00:00;0;20;4;1;5;4;0;0;1;4;13;4;0;1;20;5;9
19.04.2023 01:00;0;29;0;1;0;2;0;1;3;0;3;3;0;1;29;1;2
19.04.2023 02:00;0;4;1;0;4;1;0;0;1;0;1;1;0;0;4;1;5
19.04.2023 03:00;0;3;0;1;5;0;0;0;1;0;4;1;0;0;3;1;5
19.04.2023 04:00;0;12;1;1;7;1;0;1;2;1;7;3;1;1;12;2;8
19.04.2023 05:00;0;48;21;15;16;10;7;6;13;3;20;11;6;11;48;36;26
19.04.2023 06:00;0;137;36;48;78;43;26;36;55;10;62;64;26;47;137;84;121
19.04.2023 07:00;0;364;103;75;197;207;65;184;209;72;138;291;102;228;364;178;404
19.04.2023 08:00;0;488;79;48;285;229;52;226;232;63;128;440;73;232;488;127;514
19.04.2023 09:00;0;272;48;20;108;91;33;88;104;40;71;195;41;90;272;68;199
19.04.2023 10:00;0;216;26;21;56;51;30;70;76;24;43;130;43;77;216;47;107
19.04.2023 11:00;0;240;46;23;60;65;58;119;118;38;47;143;91;118;240;69;125
19.04.2023 12:00;0;327;73;33;96;73;61;112;152;38;69;178;90;142;327;106;169
19.04.2023 13:00;0;414;62;28;100;84;57;143;204;67;83;205;93;195;414;90;184
19.04.2023 14:00;0;453;90;62;147;122;86;163;192;69;101;241;118;191;453;152;269
19.04.2023 15:00;0;519;126;51;180;151;87;216;327;89;126;302;158;322;519;177;331
19.04.2023 16:00;0;611;157;84;257;210;118;240;370;100;140;389;149;352;611;241;467
19.04.2023 17:00;0;760;159;74;245;220;106;237;375;96;128;476;175;380;760;233;465
19.04.2023 18:00;0;696;140;87;220;204;94;198;379;86;113;392;131;362;696;227;424
19.04.2023 19:00;0;482;85;55;146;121;44;109;205;69;79;183;72;258;482;140;267
19.04.2023 20:00;0;314;40;27;67;68;13;50;90;49;39;130;35;105;314;67;135
19.04.2023 21:00;0;205;26;10;37;16;11;27;48;28;28;64;16;68;205;36;53
19.04.2023 22:00;0;177;14;2;39;13;2;13;30;4;34;51;12;27;177;16;52
19.04.2023 23:00;0;110;3;2;6;16;1;9;11;6;13;18;6;10;110;5;22
20.04.2023 00:00;0;24;2;1;6;2;0;1;2;1;11;0;0;1;24;3;8
20.04.2023 01:00;0;7;1;2;1;2;0;1;1;0;4;2;0;2;7;3;3
20.04.2023 02:00;0;4;0;0;1;0;0;2;1;0;0;1;0;0;4;0;1
20.04.2023 03:00;0;2;0;0;3;0;0;0;1;0;3;1;1;0;2;0;3
20.04.2023 04:00;0;12;1;2;8;2;1;1;2;0;6;3;1;1;12;3;10
20.04.2023 05:00;0;32;19;8;16;10;3;5;6;3;15;8;3;8;32;27;26
20.04.2023 06:00;0;85;20;28;36;23;12;16;34;7;34;40;22;22;85;48;59
20.04.2023 07:00;0;290;62;49;117;115;32;83;118;51;116;164;47;150;290;111;232
20.04.2023 08:00;0;352;64;45;181;144;28;119;138;35;71;294;42;137;352;109;325
20.04.2023 09:00;0;176;20;12;52;47;6;32;50;15;46;93;18;48;176;32;99
20.04.2023 10:00;0;121;9;5;18;22;8;17;28;7;34;49;13;28;121;14;40
20.04.2023 11:00;0;158;21;8;22;19;9;32;38;14;34;38;15;29;158;29;41
20.04.2023 12:00;0;225;33;13;37;33;14;36;44;12;35;74;27;52;225;46;70
20.04.2023 13:00;0;262;33;12;62;40;11;42;65;31;49;96;18;77;262;45;102
20.04.2023 14:00;0;252;42;21;46;66;29;54;97;21;44;115;39;100;252;63;112
20.04.2023 15:00;0;363;43;24;91;75;24;76;115;52;90;129;61;103;363;67;166
20.04.2023 16:00;0;491;88;42;111;94;46;69;140;47;116;173;53;140;491;130;205
20.04.2023 17:00;0;536;79;34;138;114;41;105;162;47;102;223;61;136;536;113;252
20.04.2023 18:00;0;485;60;27;127;102;22;77;121;49;62;197;50;129;485;87;229
20.04.2023 19:00;0;362;29;18;57;38;16;32;65;29;53;77;24;84;362;47;95
20.04.2023 20:00;0;170;21;13;27;20;6;24;23;14;35;45;18;39;170;34;47
20.04.2023 21:00;0;158;10;5;26;11;5;6;27;9;16;20;9;22;158;15;37
20.04.2023 22:00;0;127;5;7;16;8;1;6;10;4;17;11;3;13;127;12;24
20.04.2023 23:00;0;51;1;2;6;2;0;1;10;5;21;4;0;9;51;3;8
21.04.2023 00:00;0;18;2;0;3;1;0;1;2;2;0;2;1;1;18;2;4
21.04.2023 01:00;0;7;0;2;3;0;0;0;2;1;2;1;1;1;7;2;3
21.04.2023 02:00;0;11;0;1;1;0;0;0;1;0;0;0;1;1;11;1;1
21.04.2023 03:00;0;1;0;0;1;2;1;2;1;0;1;1;0;0;1;0;3
21.04.2023 04:00;0;12;4;1;5;1;1;0;1;0;6;3;2;0;12;5;6
21.04.2023 05:00;0;36;18;7;9;9;8;10;10;4;20;13;11;9;36;25;18
21.04.2023 06:00;0;100;24;38;46;32;19;32;51;7;46;51;34;43;100;62;78
21.04.2023 07:00;0;332;84;64;142;137;52;143;150;65;114;194;83;160;332;148;279
21.04.2023 08:00;0;351;61;39;169;145;36;140;143;65;98;259;58;129;351;100;314
21.04.2023 09:00;0;313;33;21;85;68;24;79;108;25;80;159;48;89;313;54;153
21.04.2023 10:00;0;261;25;26;32;46;29;70;70;33;48;93;70;88;261;51;78
21.04.2023 11:00;0;302;40;24;63;56;31;100;100;26;67;148;54;99;302;64;119
21.04.2023 12:00;0;382;72;33;82;66;76;102;134;43;64;177;83;147;382;105;148
21.04.2023 13:00;0;504;92;43;119;103;72;130;193;76;88;249;104;202;504;135;222
21.04.2023 14:00;0;500;98;42;142;119;81;197;236;66;101;250;148;229;500;140;261
21.04.2023 15:00;0;538;113;56;178;130;93;245;276;84;98;279;157;264;538;169;308
21.04.2023 16:00;0;555;120;45;168;153;101;206;319;81;90;348;147;270;555;165;321
21.04.2023 17:00;0;582;98;49;173;142;91;209;272;82;86;368;158;287;582;147;315
21.04.2023 18:00;0;554;94;57;138;116;56;165;286;54;87;299;108;310;554;151;254
21.04.2023 19:00;0;416;61;31;91;85;50;103;217;63;82;211;74;215;416;92;176
21.04.2023 20:00;0;285;37;20;62;51;18;69;92;44;45;89;26;118;285;57;113
21.04.2023 21:00;0;164;6;5;29;23;1;13;30;6;24;39;11;37;164;11;52
21.04.2023 22:00;0;141;5;0;27;14;3;9;38;8;19;34;0;60;141;5;41
21.04.2023 23:00;0;141;4;3;21;30;1;11;27;6;17;29;3;18;141;7;51
22.04.2023 00:00;0;87;12;2;17;13;0;7;22;4;13;16;1;21;87;14;30
22.04.2023 01:00;0;57;2;2;8;7;0;2;27;5;3;5;0;23;57;4;15
22.04.2023 02:00;0;31;3;0;5;14;1;1;12;1;5;6;0;13;31;3;19
22.04.2023 03:00;0;20;0;0;2;4;0;0;8;0;2;10;0;3;20;0;6
22.04.2023 04:00;0;17;0;0;6;15;0;2;10;0;5;8;1;5;17;0;21
22.04.2023 05:00;0;12;3;1;3;4;1;2;6;0;8;1;1;2;12;4;7
22.04.2023 06:00;0;16;4;5;9;6;4;3;12;0;6;11;4;11;16;9;15
22.04.2023 07:00;0;43;15;6;13;12;6;10;25;4;14;16;8;21;43;21;25
22.04.2023 08:00;0;83;26;14;21;33;15;41;43;14;32;58;29;38;83;40;54
22.04.2023 09:00;0;207;37;29;56;61;33;64;98;33;56;102;55;96;207;66;117
22.04.2023 10:00;0;276;73;42;89;72;86;135;170;63;62;190;107;180;276;115;161
22.04.2023 11:00;0;296;82;55;79;102;98;201;229;74;82;270;182;209;296;137;181
22.04.2023 12:00;0;445;128;57;142;83;176;239;304;66;76;317;214;299;445;185;225
22.04.2023 13:00;0;510;129;62;126;122;127;252;298;59;103;350;184;267;510;191;248
22.04.2023 14:00;0;487;109;57;156;117;151;299;330;93;66;328;202;329;487;166;273
22.04.2023 15:00;0;469;103;51;158;123;137;246;372;68;69;308;199;314;469;154;281
22.04.2023 16:00;0;386;64;49;126;94;109;216;240;78;53;287;130;234;386;113;220
22.04.2023 17:00;0;351;61;36;89;86;62;140;187;39;47;215;104;180;351;97;175
22.04.2023 18:00;0;299;24;21;73;67;35;85;107;46;61;113;67;121;299;45;140
22.04.2023 19:00;0;203;20;12;45;32;17;36;66;20;21;90;38;63;203;32;77
22.04.2023 20:00;0;167;13;17;20;23;4;33;38;15;30;40;22;36;167;30;43
22.04.2023 21:00;0;96;5;2;20;12;5;16;25;8;21;38;19;27;96;7;32
22.04.2023 22:00;0;75;14;0;19;12;5;20;30;10;18;21;5;24;75;14;31
22.04.2023 23:00;0;73;8;4;23;9;3;9;8;4;9;24;5;9;73;12;32
23.04.2023 00:00;0;64;8;2;4;10;0;2;12;2;4;5;1;9;64;10;14
23.04.2023 01:00;0;45;2;0;7;5;0;3;5;2;5;5;1;3;45;2;12
23.04.2023 02:00;0;31;4;2;1;2;0;3;0;1;2;4;1;1;31;6;3
23.04.2023 03:00;0;15;1;2;0;0;0;0;1;0;1;1;1;1;15;3;0
23.04.2023 04:00;0;4;0;0;2;1;0;1;0;0;3;2;0;0;4;0;3
23.04.2023 05:00;0;15;1;0;3;3;0;2;4;2;3;2;2;5;15;1;6
23.04.2023 06:00;0;23;2;2;9;8;2;4;6;2;7;12;5;6;23;4;17
23.04.2023 07:00;0;45;13;5;16;13;12;28;22;12;12;34;18;17;45;18;29
23.04.2023 08:00;0;158;24;7;30;36;10;40;47;19;26;64;41;61;158;31;66
23.04.2023 09:00;0;219;57;38;72;134;30;64;170;51;18;12;51;121;219;95;206
23.04.2023 10:00;0;258;117;42;150;136;92;141;199;69;49;12;123;177;258;159;286
23.04.2023 11:00;0;267;126;50;157;229;120;197;319;62;57;26;174;271;267;176;386
23.04.2023 12:00;0;340;161;61;175;156;128;261;392;113;67;104;208;331;340;222;331
23.04.2023 13:00;0;340;134;72;210;160;136;287;334;99;80;3;205;281;340;206;370
23.04.2023 14:00;0;322;133;52;179;163;161;245;363;94;53;146;174;297;322;185;342
23.04.2023 15:00;0;439;117;74;182;167;157;243;347;85;67;320;218;301;439;191;349
23.04.2023 16:00;0;317;60;37;123;102;57;165;233;55;63;196;151;220;317;97;225
23.04.2023 17:00;0;267;50;27;91;86;59;124;190;49;48;163;112;146;267;77;177
23.04.2023 18:00;0;147;26;18;63;30;15;34;65;20;26;41;38;59;147;44;93
23.04.2023 19:00;0;117;16;13;29;14;8;23;39;15;15;53;27;45;117;29;43
23.04.2023 20:00;0;88;8;3;14;12;7;30;33;14;13;25;20;33;88;11;26
23.04.2023 21:00;0;66;4;3;14;12;3;10;19;5;9;16;5;14;66;7;26
23.04.2023 22:00;0;53;3;3;11;4;0;3;5;6;8;8;2;6;53;6;15
23.04.2023 23:00;0;26;0;0;2;0;0;0;5;3;4;8;1;4;26;0;2
24.04.2023 00:00;0;12;0;0;2;3;0;1;2;0;1;1;1;0;12;0;5
24.04.2023 01:00;0;2;0;0;2;0;0;1;0;1;0;1;0;1;2;0;2
24.04.2023 02:00;0;6;0;0;3;1;0;0;1;0;0;0;0;0;6;0;4
24.04.2023 03:00;0;2;3;0;3;1;1;0;1;0;2;0;0;0;2;3;4
24.04.2023 04:00;0;11;2;1;2;2;1;0;0;0;7;4;2;0;11;3;4
24.04.2023 05:00;0;32;9;14;14;8;2;6;7;2;14;15;2;9;32;23;22
24.04.2023 06:00;0;108;28;35;63;47;15;24;47;9;52;47;18;42;108;63;110
24.04.2023 07:00;0;341;84;60;187;177;56;139;180;62;124;247;77;198;341;144;364
24.04.2023 08:00;0;377;57;40;193;165;20;146;169;53;108;309;51;159;377;97;358
24.04.2023 09:00;0;164;26;8;36;35;6;45;27;10;40;92;15;25;164;34;71
24.04.2023 10:00;0;80;11;2;21;14;5;15;13;5;15;36;10;18;80;13;35
24.04.2023 11:00;0;73;3;6;15;14;3;21;19;8;15;21;14;14;73;9;29
24.04.2023 12:00;0;110;15;8;27;24;8;11;23;18;28;32;12;19;110;23;51
24.04.2023 13:00;0;242;29;8;36;51;14;27;57;30;42;62;28;56;242;37;87
24.04.2023 14:00;0;259;32;22;52;38;14;44;74;33;67;85;20;68;259;54;90
24.04.2023 15:00;0;325;60;17;94;64;25;57;79;46;78;138;35;91;325;77;158
24.04.2023 16:00;0;457;75;35;126;92;27;98;144;51;99;173;41;127;457;110;218
24.04.2023 17:00;0;518;67;40;145;117;44;125;174;64;99;259;67;158;518;107;262
24.04.2023 18:00;0;459;63;26;106;105;39;97;145;47;76;242;58;159;459;89;211
24.04.2023 19:00;130;326;42;15;64;61;19;67;107;14;63;120;28;112;456;57;125
24.04.2023 20:00;117;195;27;16;27;26;8;25;50;15;40;62;22;59;312;43;53
24.04.2023 21:00;24;154;5;3;15;13;1;9;18;16;26;26;3;30;178;8;28
24.04.2023 22:00;0;113;6;4;15;9;0;8;14;8;24;14;4;14;113;10;24
24.04.2023 23:00;1;38;2;1;7;2;0;1;4;7;7;2;1;4;39;3;9
25.04.2023 00:00;5;17;0;3;2;2;5;0;3;2;3;3;3;3;22;3;4
25.04.2023 01:00;0;13;1;3;1;1;0;0;1;0;0;2;0;0;13;4;2
25.04.2023 02:00;0;11;0;1;2;0;0;1;0;0;0;1;0;0;11;1;2
25.04.2023 03:00;0;1;1;0;1;0;1;0;1;0;2;0;0;0;1;1;1
25.04.2023 04:00;0;13;1;0;3;3;0;0;3;0;3;5;1;2;13;1;6
25.04.2023 05:00;0;31;11;12;14;9;4;5;13;3;19;13;4;15;31;23;23
25.04.2023 06:00;0;128;31;44;69;45;24;33;59;12;47;65;25;42;128;75;114
25.04.2023 07:00;0;389;85;55;167;174;54;142;178;65;133;273;89;193;389;140;341
25.04.2023 08:00;0;416;74;47;270;214;47;193;228;48;123;402;75;190;416;121;484
25.04.2023 09:00;0;255;47;16;103;85;17;95;89;31;63;170;46;84;255;63;188
25.04.2023 10:00;0;197;36;9;51;44;18;55;49;30;53;96;45;62;197;45;95
25.04.2023 11:00;0;238;23;18;51;37;38;59;69;25;52;90;37;71;238;41;88
25.04.2023 12:00;0;292;53;16;64;50;25;61;90;33;56;111;50;87;292;69;114
25.04.2023 13:00;0;357;53;22;77;58;27;61;109;47;62;116;35;106;357;75;135
25.04.2023 14:00;0;329;62;24;78;75;24;57;96;44;67;120;55;103;329;86;153
25.04.2023 15:00;0;421;59;30;111;99;29;71;137;74;92;163;41;165;421;89;210
25.04.2023 16:00;0;526;82;41;190;126;47;119;185;66;108;224;80;161;526;123;316
25.04.2023 17:00;0;570;98;41;228;171;53;144;226;67;125;353;95;238;570;139;399
25.04.2023 18:00;0;574;92;37;162;124;33;140;166;65;104;263;85;182;574;129;286
25.04.2023 19:00;0;378;30;24;80;80;17;72;131;42;57;145;73;124;378;54;160
25.04.2023 20:00;0;250;26;14;56;32;9;35;57;29;34;65;26;77;250;40;88
25.04.2023 21:00;0;193;25;8;32;26;2;17;23;17;36;62;17;34;193;33;58
25.04.2023 22:00;0;154;11;10;23;10;4;10;14;3;30;20;2;14;154;21;33
25.04.2023 23:00;0;46;2;2;14;6;0;2;9;4;8;3;3;12;46;4;20
26.04.2023 00:00;0;17;1;0;3;2;0;0;4;0;7;2;0;1;17;1;5
26.04.2023 01:00;0;8;0;1;0;0;0;1;0;0;0;0;0;0;8;1;0
26.04.2023 02:00;0;1;1;0;3;1;0;0;1;0;1;0;0;0;1;1;4
26.04.2023 03:00;0;1;0;0;1;1;0;0;1;0;1;1;0;0;1;0;2
26.04.2023 04:00;0;9;1;1;5;2;0;0;1;0;5;3;3;2;9;2;7
26.04.2023 05:00;0;34;10;11;18;9;5;5;14;3;18;16;3;13;34;21;27
26.04.2023 06:00;0;122;28;28;57;50;20;31;43;11;51;53;16;25;122;56;107
26.04.2023 07:00;0;397;91;63;192;174;47;127;177;54;115;245;85;204;397;154;366
26.04.2023 08:00;0;437;73;39;221;227;47;210;213;52;137;442;72;197;437;112;448
26.04.2023 09:00;0;287;39;27;115;116;25;105;111;40;66;210;49;83;287;66;231
26.04.2023 10:00;0;246;30;21;50;58;39;67;81;28;60;116;55;68;246;51;108
26.04.2023 11:00;0;265;30;14;57;58;32;79;71;32;50;127;55;83;265;44;115
26.04.2023 12:00;0;302;53;24;76;60;39;78;99;32;44;137;63;81;302;77;136
26.04.2023 13:00;0;341;51;20;94;59;31;91;122;57;71;147;58;126;341;71;153
26.04.2023 14:00;0;395;50;35;99;104;28;97;142;41;68;157;63;145;395;85;203
26.04.2023 15:00;0;472;70;42;158;118;53;133;182;60;100;212;89;203;472;112;276
26.04.2023 16:00;0;511;117;60;195;155;82;169;253;61;125;287;127;241;511;177;350
26.04.2023 17:00;0;710;109;61;223;203;66;196;356;85;145;440;102;303;710;170;426
26.04.2023 18:00;0;554;84;61;154;144;67;141;247;51;106;291;112;224;554;145;298
26.04.2023 19:00;0;391;60;34;105;95;33;93;183;48;57;198;60;202;391;94;200
26.04.2023 20:00;0;265;31;18;74;47;11;39;101;28;35;114;32;79;265;49;121
26.04.2023 21:00;0;190;13;16;44;25;2;26;37;12;30;52;9;52;190;29;69
26.04.2023 22:00;0;174;14;3;23;11;2;13;20;9;28;32;6;14;174;17;34
26.04.2023 23:00;0;68;6;3;7;6;0;3;13;8;8;2;2;8;68;9;13
27.04.2023 00:00;0;20;2;1;3;3;0;3;2;0;2;7;1;1;20;3;6
27.04.2023 01:00;0;16;3;0;4;0;0;0;0;1;2;1;0;0;16;3;4
27.04.2023 02:00;0;8;0;0;3;0;0;2;2;1;0;0;0;2;8;0;3
27.04.2023 03:00;0;3;0;0;3;0;0;0;1;0;2;0;0;0;3;0;3
27.04.2023 04:00;0;6;2;2;2;2;1;0;0;0;3;3;1;0;6;4;4
27.04.2023 05:00;0;45;7;8;19;11;1;6;10;1;19;13;5;9;45;15;30
27.04.2023 06:00;0;116;38;41;69;44;25;34;44;11;63;60;26;39;116;79;113
27.04.2023 07:00;0;381;82;52;183;164;57;154;177;73;134;255;89;207;381;134;347
27.04.2023 08:00;0;452;75;46;245;231;54;194;221;53;127;408;79;194;452;121;476
27.04.2023 09:00;0;301;35;28;118;98;36;78;104;34;73;200;46;92;301;63;216
27.04.2023 10:00;0;198;33;17;61;50;37;68;102;41;60;110;50;101;198;50;111
27.04.2023 11:00;0;227;35;15;59;50;39;110;143;27;52;147;89;137;227;50;109
27.04.2023 12:00;0;303;72;28;80;80;55;106;169;39;59;185;75;160;303;100;160
27.04.2023 13:00;0;361;73;31;114;76;67;115;192;57;71;181;85;185;361;104;190
27.04.2023 14:00;0;435;62;31;108;117;63;117;215;54;83;197;98;197;435;93;225
27.04.2023 15:00;0;496;97;56;170;136;73;172;227;81;117;279;153;247;496;153;306
27.04.2023 16:00;0;599;126;48;220;159;89;215;289;96;139;308;143;295;599;174;379
27.04.2023 17:00;0;651;147;62;225;238;105;229;358;106;139;415;154;324;651;209;463
27.04.2023 18:00;0;660;98;31;179;169;78;164;289;83;80;313;109;280;660;129;348
27.04.2023 19:00;0;400;63;49;144;89;41;137;161;54;85;201;100;171;400;112;233
27.04.2023 20:00;0;249;35;28;58;51;18;65;94;34;47;109;45;105;249;63;109
27.04.2023 21:00;0;202;11;12;48;30;4;23;61;13;43;50;16;80;202;23;78
27.04.2023 22:00;0;159;10;7;32;21;6;15;18;9;26;28;11;17;159;17;53
27.04.2023 23:00;0;76;1;0;9;4;0;8;18;4;9;7;3;23;76;1;13
28.04.2023 00:00;0;36;6;0;5;3;1;0;7;3;8;2;2;4;36;6;8
28.04.2023 01:00;0;9;1;0;2;0;0;0;0;0;3;1;0;1;9;1;2
28.04.2023 02:00;0;9;0;0;3;0;0;0;2;0;1;1;0;1;9;0;3
28.04.2023 03:00;0;8;0;0;3;0;0;0;3;2;1;2;0;1;8;0;3
28.04.2023 04:00;0;4;1;1;5;1;0;0;0;1;5;2;2;0;4;2;6
28.04.2023 05:00;0;28;8;3;10;8;3;7;6;0;13;15;3;4;28;11;18
28.04.2023 06:00;0;83;18;17;39;22;8;12;33;6;26;34;9;27;83;35;61
28.04.2023 07:00;0;224;53;50;90;85;25;75;88;31;64;118;56;98;224;103;175
28.04.2023 08:00;0;263;37;20;121;86;24;84;90;34;74;177;33;85;263;57;207
28.04.2023 09:00;0;203;33;13;60;51;19;34;60;21;46;121;25;53;203;46;111
28.04.2023 10:00;0;177;23;13;39;26;20;49;51;20;32;71;44;46;177;36;65
28.04.2023 11:00;0;241;20;9;52;26;24;52;58;31;56;81;52;67;241;29;78
28.04.2023 12:00;0;244;30;14;38;35;30;43;54;23;46;78;34;47;244;44;73
28.04.2023 13:00;0;338;50;22;66;48;28;54;81;39;68;136;39;91;338;72;114
28.04.2023 14:00;0;339;45;28;109;71;38;97;107;44;85;128;96;115;339;73;180
28.04.2023 15:00;0;354;50;27;92;87;41;99;118;49;76;172;53;136;354;77;179
28.04.2023 16:00;0;388;57;34;104;89;46;116;180;28;95;176;84;141;388;91;193
28.04.2023 17:00;0;464;55;23;100;92;51;107;141;78;75;195;82;146;464;78;192
28.04.2023 18:00;0;429;60;30;92;83;55;104;186;56;70;176;77;222;429;90;175
28.04.2023 19:00;0;441;47;30;88;67;32;95;169;45;58;144;66;196;441;77;155
28.04.2023 20:00;0;260;26;14;25;38;17;67;68;33;44;95;45;83;260;40;63
28.04.2023 21:00;0;165;10;3;34;32;4;18;35;22;23;50;14;38;165;13;66
28.04.2023 22:00;0;161;15;4;23;10;4;18;33;11;26;37;12;39;161;19;33
28.04.2023 23:00;0;96;1;2;11;7;2;6;17;5;8;20;1;18;96;3;18
29.04.2023 00:00;0;63;5;0;13;8;1;6;7;5;8;4;1;5;63;5;21
29.04.2023 01:00;0;49;5;1;6;4;0;1;4;4;4;10;1;3;49;6;10
29.04.2023 02:00;0;25;0;0;2;1;0;0;0;1;11;4;0;0;25;0;3
29.04.2023 03:00;0;16;2;3;4;3;0;2;3;2;3;3;1;2;16;5;7
29.04.2023 04:00;0;5;0;0;3;1;0;2;1;1;6;2;2;0;5;0;4
29.04.2023 05:00;0;13;3;4;5;2;0;1;5;0;6;3;0;5;13;7;7
29.04.2023 06:00;0;14;1;5;9;5;4;10;4;2;8;3;5;3;14;6;14
29.04.2023 07:00;0;37;8;3;12;9;5;8;11;3;7;7;3;9;37;11;21
29.04.2023 08:00;0;56;7;9;15;9;6;14;20;10;17;34;11;20;56;16;24
29.04.2023 09:00;0;135;21;12;20;27;14;18;49;27;30;52;17;47;135;33;47
29.04.2023 10:00;0;177;24;22;40;31;14;48;71;18;33;106;46;70;177;46;71
29.04.2023 11:00;0;232;37;18;52;57;45;86;92;22;53;121;104;93;232;55;109
29.04.2023 12:00;0;264;56;24;48;69;59;114;128;46;49;169;102;122;264;80;117
29.04.2023 13:00;0;271;45;17;40;38;52;107;119;47;50;171;86;113;271;62;78
29.04.2023 14:00;0;295;40;20;55;55;59;95;147;27;38;182;67;132;295;60;110
29.04.2023 15:00;0;275;66;9;53;73;68;101;125;38;50;154;96;114;275;75;126
29.04.2023 16:00;0;258;40;31;59;50;56;117;117;39;60;158;113;107;258;71;109
29.04.2023 17:00;0;318;43;32;65;65;61;113;140;31;33;204;75;117;318;75;130
29.04.2023 18:00;0;290;22;14;60;48;36;107;107;34;34;144;111;97;290;36;108
29.04.2023 19:00;0;258;25;12;48;54;26;67;103;20;30;107;53;100;258;37;102
29.04.2023 20:00;0;170;18;4;16;12;13;36;44;11;9;56;31;44;170;22;28
29.04.2023 21:00;0;101;14;8;20;12;9;14;12;7;20;25;16;22;101;22;32
29.04.2023 22:00;0;110;2;4;9;15;2;7;18;7;17;25;8;10;110;6;24
29.04.2023 23:00;0;64;13;0;15;35;0;5;33;2;8;29;4;35;64;13;50
30.04.2023 00:00;0;112;2;0;7;2;0;3;8;2;6;14;3;10;112;2;9
30.04.2023 01:00;0;55;1;0;7;6;1;4;10;1;4;14;3;7;55;1;13
30.04.2023 02:00;0;33;3;1;4;1;0;0;0;0;2;2;0;0;33;4;5
30.04.2023 03:00;0;12;0;3;2;0;0;1;0;0;3;2;0;0;12;3;2
30.04.2023 04:00;0;9;0;1;1;1;0;1;3;0;4;2;0;2;9;1;2
30.04.2023 05:00;0;8;2;1;4;1;0;1;0;0;3;1;1;1;8;3;5
30.04.2023 06:00;0;12;2;6;6;5;6;8;5;1;1;7;7;3;12;8;11
30.04.2023 07:00;0;24;7;3;10;3;5;11;19;2;3;16;6;13;24;10;13
30.04.2023 08:00;0;44;15;12;26;25;16;29;36;16;9;45;21;35;44;27;51
30.04.2023 09:00;0;106;37;19;35;38;22;73;91;20;7;86;54;87;106;56;73
30.04.2023 10:00;0;211;89;48;81;83;117;205;161;35;42;204;143;150;211;137;164
30.04.2023 11:00;0;234;128;74;154;175;219;392;400;87;62;357;333;341;234;202;329
30.04.2023 12:00;0;353;202;98;195;185;274;461;523;123;70;475;412;458;353;300;380
30.04.2023 13:00;0;365;180;104;281;237;346;529;577;125;102;575;446;516;365;284;518
30.04.2023 14:00;0;434;184;117;296;218;321;568;686;121;69;633;494;570;434;301;514
30.04.2023 15:00;0;437;197;111;330;303;301;576;673;123;70;577;437;602;437;308;633
30.04.2023 16:00;0;421;141;92;265;267;230;444;663;115;76;552;393;545;421;233;532
30.04.2023 17:00;79;407;130;99;223;217;180;358;554;106;65;444;321;491;486;229;440
30.04.2023 18:00;56;336;84;69;144;156;121;262;401;75;48;280;175;382;392;153;300
30.04.2023 19:00;55;299;64;31;99;92;59;141;238;54;33;190;115;242;354;95;191
30.04.2023 20:00;0;233;45;21;92;64;30;91;148;45;46;145;66;150;233;66;156
30.04.2023 21:00;0;179;23;9;65;51;16;51;86;34;32;87;37;85;179;32;116
30.04.2023 22:00;0;193;9;16;41;23;4;23;86;22;18;37;17;83;193;25;64
30.04.2023 23:00;0;134;5;7;23;8;2;9;26;13;17;20;5;21;134;12;31
01.05.2023 00:00;0;121;6;0;12;5;1;5;19;12;11;21;6;15;121;6;17
01.05.2023 01:00;0;109;8;9;9;5;0;4;18;6;9;17;1;16;109;17;14
01.05.2023 02:00;0;74;6;1;12;3;3;0;6;10;6;13;3;2;74;7;15
01.05.2023 03:00;0;36;6;0;4;1;2;0;3;12;16;5;3;6;36;6;5
01.05.2023 04:00;0;22;4;0;2;3;2;1;7;3;3;3;0;4;22;4;5
01.05.2023 05:00;0;17;3;3;2;5;1;2;3;3;0;5;0;3;17;6;7
01.05.2023 06:00;0;20;4;2;13;4;4;7;16;7;4;7;3;10;20;6;17
01.05.2023 07:00;0;25;6;7;21;12;2;23;23;7;5;20;17;20;25;13;33
01.05.2023 08:00;0;41;24;12;15;25;15;36;36;7;14;58;35;25;41;36;40
01.05.2023 09:00;0;77;36;22;67;26;39;63;95;17;18;99;63;76;77;58;93
01.05.2023 10:00;0;167;59;45;84;87;101;145;187;75;29;173;102;202;167;104;171
01.05.2023 11:00;0;216;103;59;113;114;139;277;303;69;36;282;256;274;216;162;227
01.05.2023 12:00;0;270;120;83;184;134;193;358;408;94;56;391;308;372;270;203;318
01.05.2023 13:00;0;313;136;94;180;195;209;410;480;89;50;444;344;363;313;230;375
01.05.2023 14:00;0;338;110;85;167;149;189;370;488;94;77;367;357;451;338;195;316
01.05.2023 15:00;0;377;118;68;218;200;192;344;478;97;47;436;232;443;377;186;418
01.05.2023 16:00;0;373;118;72;205;168;163;312;430;134;58;412;215;367;373;190;373
01.05.2023 17:00;0;260;73;34;134;83;88;199;245;60;51;234;145;200;260;107;217
01.05.2023 18:00;0;201;24;10;68;59;30;77;145;31;26;128;66;106;201;34;127
01.05.2023 19:00;0;134;22;11;35;46;16;72;124;25;22;58;67;121;134;33;81
01.05.2023 20:00;0;110;16;8;29;27;4;49;41;13;29;59;31;39;110;24;56
01.05.2023 21:00;0;86;11;9;14;12;4;20;23;10;21;37;20;35;86;20;26
01.05.2023 22:00;0;61;3;0;14;4;1;8;16;1;14;14;3;13;61;3;18
01.05.2023 23:00;0;34;1;1;5;0;0;9;4;2;4;6;1;3;34;2;5
02.05.2023 00:00;0;12;3;0;0;2;0;1;1;1;1;1;3;2;12;3;2
02.05.2023 01:00;0;5;0;0;2;0;1;0;3;0;0;0;0;0;5;0;2
02.05.2023 02:00;0;3;0;0;2;0;0;0;0;0;0;1;1;1;3;0;2
02.05.2023 03:00;0;1;0;0;3;0;0;0;1;0;1;0;0;0;1;0;3
02.05.2023 04:00;0;11;1;4;10;1;1;2;2;0;1;4;1;2;11;5;11
02.05.2023 05:00;0;40;17;10;19;10;5;7;12;3;25;10;6;10;40;27;29
02.05.2023 06:00;0;125;40;33;69;45;20;33;60;8;49;74;31;54;125;73;114
02.05.2023 07:00;0;350;79;69;164;190;56;166;177;64;121;262;87;198;350;148;354
02.05.2023 08:00;0;462;72;48;261;215;57;178;223;54;140;402;72;185;462;120;476
02.05.2023 09:00;0;263;41;14;95;74;16;75;90;29;54;162;43;85;263;55;169
02.05.2023 10:00;0;185;14;19;28;40;6;49;47;20;43;77;27;57;185;33;68
02.05.2023 11:00;0;205;16;6;40;33;20;55;48;22;44;86;53;57;205;22;73
02.05.2023 12:00;0;246;36;14;50;45;43;54;55;26;63;115;43;62;246;50;95
02.05.2023 13:00;0;360;47;14;90;60;39;83;90;44;48;130;55;122;360;61;150
02.05.2023 14:00;0;357;55;20;99;77;28;73;107;28;71;151;55;104;357;75;176
02.05.2023 15:00;0;406;75;36;142;131;29;130;188;55;91;207;80;143;406;111;273
02.05.2023 16:00;0;547;107;47;199;144;46;199;230;84;128;283;124;216;547;154;343
02.05.2023 17:00;0;636;107;84;196;226;66;145;311;78;116;375;112;258;636;191;422
02.05.2023 18:00;0;617;89;40;171;137;53;157;216;85;102;324;113;267;617;129;308
02.05.2023 19:00;0;432;48;33;90;111;42;90;168;65;83;159;66;174;432;81;201
02.05.2023 20:00;0;298;35;16;72;47;11;49;85;45;38;99;49;127;298;51;119
02.05.2023 21:00;0;199;25;9;32;30;4;38;36;14;25;75;38;44;199;34;62
02.05.2023 22:00;0;137;17;1;24;11;3;7;12;11;28;25;7;8;137;18;35
02.05.2023 23:00;0;54;3;2;4;3;0;5;8;2;12;9;3;5;54;5;7
03.05.2023 00:00;0;12;1;0;4;1;0;2;1;1;7;0;0;1;12;1;5
03.05.2023 01:00;0;9;0;0;1;0;0;0;1;0;2;0;0;1;9;0;1
03.05.2023 02:00;0;3;0;0;3;1;0;1;0;0;1;1;0;1;3;0;4
03.05.2023 03:00;0;2;1;0;2;0;0;0;3;0;1;0;0;0;2;1;2
03.05.2023 04:00;0;6;0;2;9;1;1;4;2;0;7;6;2;2;6;2;10
03.05.2023 05:00;0;39;14;10;19;13;4;6;10;4;17;18;2;9;39;24;32
03.05.2023 06:00;0;136;42;40;88;47;27;48;53;18;62;77;29;41;136;82;135
03.05.2023 07:00;0;436;101;86;219;197;72;191;187;68;137;302;118;229;436;187;416
03.05.2023 08:00;0;475;84;48;280;279;83;225;253;46;128;534;89;209;475;132;559
03.05.2023 09:00;0;312;44;29;90;123;43;96;127;23;74;239;65;118;312;73;213
03.05.2023 10:00;0;233;31;20;67;69;35;91;106;28;59;111;73;91;233;51;136
03.05.2023 11:00;0;283;45;34;67;68;73;118;105;38;51;164;122;106;283;79;135
03.05.2023 12:00;0;331;56;21;109;78;65;175;160;41;74;201;137;148;331;77;187
03.05.2023 13:00;0;433;86;38;118;72;81;151;177;63;84;221;123;195;433;124;190
03.05.2023 14:00;0;451;84;50;145;102;67;202;258;72;87;253;130;252;451;134;247
03.05.2023 15:00;0;533;117;60;216;143;111;203;306;83;112;322;192;286;533;177;359
03.05.2023 16:00;0;697;163;77;286;207;96;258;376;98;126;390;165;339;697;240;493
03.05.2023 17:00;0;845;161;101;328;250;132;255;468;122;142;526;187;420;845;262;578
03.05.2023 18:00;0;717;132;79;242;187;102;215;412;107;110;433;134;416;717;211;429
03.05.2023 19:00;0;555;85;49;179;124;59;153;294;70;90;288;125;316;555;134;303
03.05.2023 20:00;0;370;73;39;107;84;36;108;185;63;47;149;60;212;370;112;191
03.05.2023 21:00;0;253;31;10;56;36;12;38;83;39;36;108;27;102;253;41;92
03.05.2023 22:00;0;196;18;6;42;19;8;17;27;17;25;37;11;24;196;24;61
03.05.2023 23:00;0;77;11;4;14;6;3;3;12;4;18;21;1;11;77;15;20
04.05.2023 00:00;0;30;2;1;11;4;1;1;5;1;3;5;2;5;30;3;15
04.05.2023 01:00;0;14;0;1;2;0;0;0;1;1;2;3;0;1;14;1;2
04.05.2023 02:00;0;4;1;3;1;0;0;0;1;0;0;0;0;0;4;4;1
04.05.2023 03:00;0;2;3;0;6;0;1;0;1;0;0;1;0;0;2;3;6
04.05.2023 04:00;0;6;4;4;4;1;0;1;2;0;6;3;1;0;6;8;5
04.05.2023 05:00;0;49;19;10;12;9;7;13;8;3;15;17;10;9;49;29;21
04.05.2023 06:00;0;144;46;57;88;50;30;49;60;11;62;81;35;51;144;103;138
04.05.2023 07:00;0;434;100;65;237;199;68;177;213;73;151;323;114;237;434;165;436
04.05.2023 08:00;0;512;89;59;325;280;74;220;266;67;156;486;84;117;512;148;605
04.05.2023 09:00;0;301;55;46;101;112;45;109;105;30;78;247;59;7;301;101;213
04.05.2023 10:00;0;258;51;37;57;66;57;96;126;26;66;170;74;89;258;88;123
04.05.2023 11:00;0;294;53;33;70;69;74;175;166;38;53;186;140;160;294;86;139
04.05.2023 12:00;0;383;70;50;93;82;80;168;180;43;76;237;132;163;383;120;175
04.05.2023 13:00;0;504;83;31;142;99;75;189;221;76;85;232;148;225;504;114;241
04.05.2023 14:00;0;466;110;63;163;114;113;237;269;65;117;304;167;246;466;173;277
04.05.2023 15:00;0;569;121;74;234;173;119;260;307;77;124;403;178;273;569;195;407
04.05.2023 16:00;0;741;181;91;290;234;148;289;398;120;189;437;258;393;741;272;524
04.05.2023 17:00;0;838;144;72;329;288;133;332;480;120;152;506;228;457;838;216;617
04.05.2023 18:00;0;715;143;79;255;205;114;272;402;93;137;437;169;450;715;222;460
04.05.2023 19:00;0;549;88;63;158;140;74;169;279;101;105;247;121;338;549;151;298
04.05.2023 20:00;0;363;61;36;134;81;35;132;180;37;49;203;72;211;363;97;215
04.05.2023 21:00;0;284;43;27;82;60;22;61;150;33;56;98;40;132;284;70;142
04.05.2023 22:00;0;203;24;8;43;15;10;32;38;16;39;44;11;43;203;32;58
04.05.2023 23:00;0;86;4;4;17;10;1;10;17;14;14;20;4;28;86;8;27
05.05.2023 00:00;0;42;7;1;5;3;0;3;4;0;9;7;1;4;42;8;8
05.05.2023 01:00;0;15;1;1;3;2;1;0;3;0;3;5;0;1;15;2;5
05.05.2023 02:00;0;11;0;1;1;0;0;2;4;1;4;1;0;3;11;1;1
05.05.2023 03:00;0;3;0;1;3;0;0;0;3;2;5;1;1;0;3;1;3
05.05.2023 04:00;0;11;2;2;7;2;1;0;3;0;8;2;1;2;11;4;9
05.05.2023 05:00;0;38;16;9;10;11;7;7;13;2;17;15;3;9;38;25;21
05.05.2023 06:00;0;120;35;35;70;41;22;34;55;9;40;54;26;50;120;70;111
05.05.2023 07:00;0;331;57;66;154;141;41;129;171;61;120;194;75;196;331;123;295
05.05.2023 08:00;0;341;59;35;199;169;47;168;173;62;94;288;58;151;341;94;368
05.05.2023 09:00;0;256;53;26;86;79;30;83;109;34;76;195;55;100;256;79;165
05.05.2023 10:00;0;222;25;21;57;43;46;91;95;24;66;123;56;87;222;46;100
05.05.2023 11:00;0;294;45;22;64;71;66;118;127;26;59;145;102;116;294;67;135
05.05.2023 12:00;0;358;71;31;86;55;45;106;108;31;101;185;74;114;358;102;141
05.05.2023 13:00;0;500;64;42;130;76;44;99;153;62;95;190;68;147;500;106;206
05.05.2023 14:00;0;343;45;19;125;75;39;100;119;44;94;125;77;115;343;64;200
05.05.2023 15:00;0;419;56;36;128;110;34;116;141;52;77;196;83;145;419;92;238
05.05.2023 16:00;0;417;53;21;117;105;41;125;166;43;102;246;78;141;417;74;222
05.05.2023 17:00;0;410;48;26;108;101;37;107;161;51;63;210;73;140;410;74;209
05.05.2023 18:00;0;383;33;13;105;64;30;102;111;40;79;196;101;107;383;46;169
05.05.2023 19:00;0;307;37;23;100;122;26;110;130;38;50;248;81;131;307;60;222
05.05.2023 20:00;0;190;25;4;75;80;17;53;107;15;30;167;32;90;190;29;155
05.05.2023 21:00;0;143;15;5;68;58;10;32;58;13;25;109;25;46;143;20;126
05.05.2023 22:00;0;133;9;5;63;56;3;36;37;10;20;103;20;41;133;14;119
05.05.2023 23:00;0;100;11;1;51;45;3;14;31;4;14;111;12;22;100;12;96
06.05.2023 00:00;0;70;6;3;62;34;0;19;37;6;12;191;12;27;70;9;96
06.05.2023 01:00;0;49;8;1;14;12;0;4;8;2;3;53;5;4;49;9;26
06.05.2023 02:00;0;24;3;0;4;1;0;3;1;2;2;4;1;2;24;3;5
06.05.2023 03:00;0;13;0;3;3;1;0;1;1;0;7;5;0;0;13;3;4
06.05.2023 04:00;0;8;1;1;5;2;0;1;2;0;4;2;0;0;8;2;7
06.05.2023 05:00;0;16;5;1;5;6;2;2;3;1;12;8;1;3;16;6;11
06.05.2023 06:00;0;13;9;5;7;3;6;3;8;2;7;14;3;10;13;14;10
06.05.2023 07:00;0;40;10;6;14;15;8;24;34;11;9;26;11;29;40;16;29
06.05.2023 08:00;0;105;31;13;53;38;29;45;59;20;19;78;37;63;105;44;91
06.05.2023 09:00;0;193;36;36;67;59;37;87;119;34;58;121;56;116;193;72;126
06.05.2023 10:00;0;290;80;38;109;61;72;129;213;57;57;192;131;171;290;118;170
06.05.2023 11:00;0;374;83;49;127;110;114;191;264;68;62;307;206;264;374;132;237
06.05.2023 12:00;0;399;95;64;128;92;127;239;284;81;67;331;198;249;399;159;220
06.05.2023 13:00;0;467;140;55;135;134;158;296;338;61;60;328;257;309;467;195;269
06.05.2023 14:00;0;490;105;57;162;140;150;288;321;94;71;401;231;285;490;162;302
06.05.2023 15:00;0;445;99;67;158;177;133;276;287;118;69;380;215;273;445;166;335
06.05.2023 16:00;0;269;29;19;113;56;53;148;156;38;29;185;133;116;269;48;169
06.05.2023 17:00;0;293;18;20;66;85;18;87;109;43;39;181;56;137;293;38;151
06.05.2023 18:00;0;260;29;15;128;124;25;88;176;38;60;245;73;140;260;44;252
06.05.2023 19:00;0;269;38;8;125;196;12;115;252;70;27;385;79;186;269;46;321
06.05.2023 20:00;0;213;39;4;151;191;34;97;286;50;26;467;64;182;213;43;342
06.05.2023 21:00;0;153;15;7;134;179;14;118;275;27;13;426;110;193;153;22;313
06.05.2023 22:00;0;161;17;1;183;184;2;225;302;38;13;379;45;212;161;18;367
06.05.2023 23:00;0;143;10;3;95;160;0;168;492;28;9;322;27;226;143;13;255
07.05.2023 00:00;0;257;22;19;149;203;18;79;340;78;19;886;74;327;257;41;352
07.05.2023 01:00;0;80;3;3;35;35;2;15;34;9;14;212;14;41;80;6;70
07.05.2023 02:00;0;50;5;5;10;7;2;10;20;4;6;41;2;17;50;10;17
07.05.2023 03:00;0;26;3;5;12;6;3;5;6;4;8;6;3;5;26;8;18
07.05.2023 04:00;0;10;0;2;0;2;0;1;8;1;8;5;0;8;10;2;2
07.05.2023 05:00;0;14;4;1;4;8;2;4;5;2;4;5;5;2;14;5;12
07.05.2023 06:00;0;15;2;2;11;5;1;4;11;0;2;10;4;6;15;4;16
07.05.2023 07:00;0;14;9;6;14;14;7;9;24;7;5;17;7;21;14;15;28
07.05.2023 08:00;0;63;24;9;28;25;10;36;48;8;11;37;49;37;63;33;53
07.05.2023 09:00;0;116;54;17;47;46;29;62;88;28;22;73;54;95;116;71;93
07.05.2023 10:00;0;191;94;42;95;88;64;159;198;42;32;136;122;186;191;136;183
07.05.2023 11:00;0;207;119;66;131;119;93;219;252;69;43;219;185;244;207;185;250
07.05.2023 12:00;0;270;104;52;136;176;144;309;323;56;61;345;217;268;270;156;312
07.05.2023 13:00;0;340;90;73;213;201;142;383;424;82;60;353;294;374;340;163;414
07.05.2023 14:00;0;282;103;46;216;215;88;334;331;71;52;439;245;289;282;149;431
07.05.2023 15:00;0;223;61;38;168;108;46;280;272;51;37;219;175;218;223;99;276
07.05.2023 16:00;0;261;53;30;143;92;62;140;214;57;34;227;98;205;261;83;235
07.05.2023 17:00;0;196;25;13;72;56;43;38;84;22;36;87;34;64;196;38;128
07.05.2023 18:00;0;168;20;10;42;29;23;15;48;15;40;108;22;75;168;30;71
07.05.2023 19:00;0;91;12;9;26;12;14;20;11;11;8;39;9;17;91;21;38
07.05.2023 20:00;0;62;8;2;17;12;4;12;17;5;19;20;4;18;62;10;29
07.05.2023 21:00;0;69;10;4;9;12;7;5;33;8;10;10;7;29;69;14;21
07.05.2023 22:00;0;28;4;3;1;6;2;3;3;1;5;1;2;7;28;7;7
07.05.2023 23:00;0;15;1;0;0;1;0;0;2;1;3;3;0;0;15;1;1
08.05.2023 00:00;0;7;0;0;3;3;0;0;1;0;3;2;0;2;7;0;6
08.05.2023 01:00;0;2;0;0;2;1;0;1;2;0;0;2;1;0;2;0;3
08.05.2023 02:00;0;4;0;0;2;0;0;1;1;0;1;0;0;0;4;0;2
08.05.2023 03:00;0;1;0;0;2;0;0;0;1;0;2;1;0;0;1;0;2
08.05.2023 04:00;0;9;0;3;4;0;0;0;0;0;6;3;1;0;9;3;4
08.05.2023 05:00;0;34;14;11;18;6;5;5;6;4;24;12;6;6;34;25;24
08.05.2023 06:00;0;137;39;31;66;29;28;24;44;9;44;50;24;43;137;70;95
08.05.2023 07:00;0;361;70;66;157;170;63;111;163;52;111;236;68;189;361;136;327
08.05.2023 08:00;0;379;73;39;222;198;43;158;190;57;116;399;54;156;379;112;420
08.05.2023 09:00;0;246;41;16;97;77;24;97;75;29;68;155;43;91;246;57;174
08.05.2023 10:00;0;186;30;21;39;33;27;59;75;21;38;97;34;72;186;51;72
08.05.2023 11:00;0;195;27;20;51;42;26;51;75;24;42;112;55;65;195;47;93
08.05.2023 12:00;72;256;36;15;39;54;24;81;68;25;57;104;65;82;328;51;93
08.05.2023 13:00;47;312;38;17;82;64;45;62;67;36;72;115;57;75;359;55;146
08.05.2023 14:00;192;343;47;31;70;69;34;73;87;43;68;131;47;83;535;78;139
08.05.2023 15:00;193;411;73;41;118;106;47;123;164;60;87;210;91;167;604;114;224
08.05.2023 16:00;302;560;108;65;201;148;72;160;268;78;120;267;126;274;862;173;349
08.05.2023 17:00;201;595;106;38;213;163;67;200;289;94;130;376;120;290;796;144;376
08.05.2023 18:00;64;650;101;55;164;156;64;189;298;79;96;348;118;353;714;156;320
08.05.2023 19:00;0;376;75;47;90;138;46;99;178;61;68;217;80;261;376;122;228
08.05.2023 20:00;0;242;49;22;50;62;28;76;115;25;36;133;43;127;242;71;112
08.05.2023 21:00;0;190;13;11;45;22;13;40;67;28;24;66;28;83;190;24;67
08.05.2023 22:00;0;144;8;4;32;17;3;12;24;11;29;16;5;22;144;12;49
08.05.2023 23:00;0;59;4;4;5;7;3;2;19;3;10;10;3;16;59;8;12
09.05.2023 00:00;0;15;2;2;2;2;0;1;2;2;4;3;0;5;15;4;4
09.05.2023 01:00;0;2;3;0;3;3;0;1;1;0;1;0;1;2;2;3;6
09.05.2023 02:00;0;4;1;0;1;0;0;0;2;0;0;3;0;0;4;1;1
09.05.2023 03:00;0;2;0;0;3;0;0;0;1;0;4;1;0;0;2;0;3
09.05.2023 04:00;0;8;1;3;2;1;0;0;3;1;8;5;1;4;8;4;3
09.05.2023 05:00;0;32;11;16;21;10;6;8;12;4;16;7;5;8;32;27;31
09.05.2023 06:00;0;121;36;36;61;34;20;37;55;13;49;67;27;52;121;72;95
09.05.2023 07:00;0;371;84;53;151;185;58;131;178;57;137;234;74;158;371;137;336
09.05.2023 08:00;0;437;71;42;215;213;43;193;220;52;92;426;77;185;437;113;428
09.05.2023 09:00;0;238;40;15;97;94;45;120;99;35;54;201;52;95;238;55;191
09.05.2023 10:00;0;226;27;14;81;48;23;79;114;29;56;125;60;104;226;41;129
09.05.2023 11:00;0;248;39;19;43;38;27;79;107;22;50;104;71;98;248;58;81
09.05.2023 12:00;0;318;52;30;67;58;26;91;126;43;53;135;46;105;318;82;125
09.05.2023 13:00;0;366;49;24;85;64;36;66;108;45;71;158;59;129;366;73;149
09.05.2023 14:00;0;375;70;38;92;92;30;112;115;48;82;157;61;132;375;108;184
09.05.2023 15:00;0;392;61;31;120;106;32;138;146;67;92;195;72;155;392;92;226
09.05.2023 16:00;0;460;70;41;171;101;35;108;141;60;120;192;85;132;460;111;272
09.05.2023 17:00;0;404;52;24;121;92;28;69;104;24;73;195;46;88;404;76;213
09.05.2023 18:00;0;320;40;16;84;70;27;59;81;12;62;133;27;83;320;56;154
09.05.2023 19:00;0;242;12;12;56;36;13;26;38;15;42;65;15;54;242;24;92
09.05.2023 20:00;0;154;11;4;29;12;4;14;23;10;24;31;9;34;154;15;41
09.05.2023 21:00;0;139;7;2;17;8;0;12;16;6;15;27;6;24;139;9;25
09.05.2023 22:00;0;68;4;3;9;6;1;12;5;1;14;15;5;10;68;7;15
09.05.2023 23:00;0;43;0;3;5;2;0;1;2;5;8;1;1;3;43;3;7
10.05.2023 00:00;0;15;2;0;4;0;0;0;4;0;8;4;0;2;15;2;4
10.05.2023 01:00;0;10;0;1;2;1;0;0;3;1;2;0;0;1;10;1;3
10.05.2023 02:00;0;3;3;0;5;0;0;1;2;0;0;0;1;2;3;3;5
10.05.2023 03:00;0;1;0;0;3;0;0;0;1;0;3;2;0;1;1;0;3
10.05.2023 04:00;0;7;0;3;5;2;0;0;2;1;3;3;1;2;7;3;7
10.05.2023 05:00;0;34;6;11;14;3;3;4;10;4;17;14;3;6;34;17;17
10.05.2023 06:00;0;108;26;24;51;36;18;28;34;8;36;52;18;30;108;50;87
10.05.2023 07:00;0;293;68;51;133;144;42;120;130;47;96;227;77;141;293;119;277
10.05.2023 08:00;0;373;53;32;194;201;33;134;156;37;102;339;59;142;373;85;395
10.05.2023 09:00;0;204;29;17;76;86;16;53;85;30;57;115;36;71;204;46;162
10.05.2023 10:00;0;164;18;13;44;24;11;36;37;15;35;68;32;37;164;31;68
10.05.2023 11:00;0;197;21;6;22;28;12;24;32;17;30;61;16;36;197;27;50
10.05.2023 12:00;0;215;25;7;31;36;14;42;52;19;51;71;37;45;215;32;67
10.05.2023 13:00;0;263;38;16;67;46;27;46;76;30;55;83;28;74;263;54;113
10.05.2023 14:00;0;317;45;20;62;63;45;49;78;28;64;107;39;87;317;65;125
10.05.2023 15:00;0;343;37;26;86;80;36;58;82;34;63;142;47;89;343;63;166
10.05.2023 16:00;0;450;70;39;121;92;31;68;99;26;94;154;47;103;450;109;213
10.05.2023 17:00;0;426;59;38;154;122;46;111;137;27;90;239;59;107;426;97;276
10.05.2023 18:00;0;377;46;16;102;88;30;85;105;48;50;172;57;106;377;62;190
10.05.2023 19:00;0;275;28;17;67;50;17;41;92;27;57;110;38;90;275;45;117
10.05.2023 20:00;0;206;27;13;34;39;14;33;53;19;30;90;19;50;206;40;73
10.05.2023 21:00;0;138;9;6;24;17;12;24;36;13;20;46;8;47;138;15;41
10.05.2023 22:00;0;119;9;7;23;10;0;7;14;5;28;34;1;18;119;16;33
10.05.2023 23:00;0;58;6;3;10;6;0;6;13;2;11;21;2;11;58;9;16
11.05.2023 00:00;0;17;3;1;5;1;0;0;2;1;5;3;2;1;17;4;6
11.05.2023 01:00;0;8;1;0;2;1;0;2;0;0;5;1;0;0;8;1;3
11.05.2023 02:00;0;4;0;0;1;0;0;2;3;0;1;0;0;2;4;0;1
11.05.2023 03:00;0;2;0;0;4;0;0;1;1;0;1;0;0;0;2;0;4
11.05.2023 04:00;0;6;0;3;2;2;0;0;3;0;3;6;2;3;6;3;4
11.05.2023 05:00;0;40;13;15;17;4;3;4;8;2;25;11;1;9;40;28;21
11.05.2023 06:00;0;109;38;37;61;47;21;38;54;11;50;66;25;46;109;75;108
11.05.2023 07:00;0;336;101;66;179;182;55;131;185;67;114;237;81;189;336;167;361
11.05.2023 08:00;0;379;66;33;219;213;52;158;203;54;116;377;58;188;379;99;432
11.05.2023 09:00;0;266;39;20;96;79;33;57;78;19;71;157;43;74;266;59;175
11.05.2023 10:00;0;177;37;17;51;45;29;87;105;43;62;93;52;94;177;54;96
11.05.2023 11:00;0;213;49;21;46;49;26;68;92;21;47;102;68;103;213;70;95
11.05.2023 12:00;0;286;37;17;60;55;30;78;111;30;61;123;59;107;286;54;115
11.05.2023 13:00;0;372;55;20;97;81;40;96;122;56;61;170;57;132;372;75;178
11.05.2023 14:00;0;355;53;29;108;99;33;97;162;50;67;172;59;149;355;82;207
11.05.2023 15:00;0;393;92;42;128;114;47;116;159;76;115;209;88;162;393;134;242
11.05.2023 16:00;0;527;107;49;174;131;56;164;225;64;118;278;94;204;527;156;305
11.05.2023 17:00;0;612;95;61;189;163;61;176;199;68;97;322;104;173;612;156;352
11.05.2023 18:00;0;454;61;32;120;90;41;82;127;42;72;213;70;122;454;93;210
11.05.2023 19:00;0;309;27;16;53;56;10;30;66;29;43;97;22;82;309;43;109
11.05.2023 20:00;0;189;17;10;44;30;10;29;40;21;31;53;9;48;189;27;74
11.05.2023 21:00;0;142;14;9;21;19;8;18;17;12;20;42;11;36;142;23;40
11.05.2023 22:00;0;124;10;6;21;10;3;8;21;10;21;24;2;12;124;16;31
11.05.2023 23:00;0;66;3;2;4;10;2;4;6;3;14;10;1;8;66;5;14
12.05.2023 00:00;0;27;1;0;5;1;0;2;2;0;2;3;2;2;27;1;6
12.05.2023 01:00;0;10;0;0;3;1;0;2;1;0;0;3;0;1;10;0;4
12.05.2023 02:00;0;10;0;2;0;0;0;0;2;0;1;1;2;1;10;2;0
12.05.2023 03:00;0;6;1;0;3;3;1;0;5;0;0;1;0;2;6;1;6
12.05.2023 04:00;0;4;0;2;2;2;0;0;5;1;5;1;3;3;4;2;4
12.05.2023 05:00;0;21;6;3;6;6;1;5;5;0;11;4;3;5;21;9;12
12.05.2023 06:00;0;90;28;21;33;21;13;17;26;7;29;31;12;23;90;49;54
12.05.2023 07:00;0;279;61;41;105;116;28;94;101;36;93;125;51;120;279;102;221
12.05.2023 08:00;0;324;63;19;115;130;24;97;124;32;72;196;47;120;324;82;245
12.05.2023 09:00;0;215;32;16;59;84;23;61;73;23;53;130;31;68;215;48;143
12.05.2023 10:00;0;224;24;21;40;30;24;62;81;20;51;98;50;97;224;45;70
12.05.2023 11:00;0;220;23;20;52;37;35;86;85;30;42;85;71;103;220;43;89
12.05.2023 12:00;0;344;54;29;69;59;37;70;112;43;64;133;54;126;344;83;128
12.05.2023 13:00;0;381;92;33;78;79;41;84;158;53;83;158;65;129;381;125;157
12.05.2023 14:00;0;438;55;31;94;81;62;128;126;57;76;175;89;154;438;86;175
12.05.2023 15:00;0;409;84;51;103;109;66;140;160;47;86;204;97;148;409;135;212
12.05.2023 16:00;0;455;99;49;132;108;87;149;183;47;96;265;87;178;455;148;240
12.05.2023 17:00;0;419;71;42;132;108;71;149;170;45;74;230;92;194;419;113;240
12.05.2023 18:00;0;464;65;45;100;92;61;151;165;63;82;194;95;203;464;110;192
12.05.2023 19:00;0;408;49;26;92;112;28;92;182;45;67;165;60;204;408;75;204
12.05.2023 20:00;0;240;48;21;49;57;18;60;113;31;25;93;35;112;240;69;106
12.05.2023 21:00;0;190;21;18;45;36;6;33;58;12;39;48;19;90;190;39;81
12.05.2023 22:00;0;185;15;3;36;62;5;14;55;13;29;39;6;52;185;18;98
12.05.2023 23:00;0;93;16;4;33;32;3;19;48;12;18;19;3;54;93;20;65
13.05.2023 00:00;0;74;5;5;10;12;3;2;13;1;13;11;4;18;74;10;22
13.05.2023 01:00;0;55;4;1;16;1;1;7;9;5;7;6;2;13;55;5;17
13.05.2023 02:00;0;34;4;4;2;1;1;0;7;1;3;4;1;5;34;8;3
13.05.2023 03:00;0;13;0;1;3;0;0;1;0;1;3;0;0;12;13;1;3
13.05.2023 04:00;0;11;2;0;2;1;2;0;1;2;2;1;0;0;11;2;3
13.05.2023 05:00;0;20;10;5;4;5;5;6;4;1;12;5;4;5;20;15;9
13.05.2023 06:00;0;25;14;3;8;4;5;5;5;3;7;11;11;3;25;17;12
13.05.2023 07:00;0;40;27;25;10;12;5;14;13;5;12;24;13;15;40;52;22
13.05.2023 08:00;0;97;38;18;33;25;20;32;59;25;30;54;47;66;97;56;58
13.05.2023 09:00;0;186;47;32;69;71;58;158;133;51;48;130;64;126;186;79;140
13.05.2023 10:00;0;304;86;48;105;95;91;190;222;64;79;227;234;206;304;134;200
13.05.2023 11:00;0;343;101;77;102;102;129;224;320;63;67;268;182;341;343;178;204
13.05.2023 12:00;0;393;112;56;151;143;110;257;354;77;86;363;254;347;393;168;294
13.05.2023 13:00;0;273;56;24;78;39;54;109;138;37;70;159;97;128;273;80;117
13.05.2023 14:00;0;336;53;23;70;63;56;126;133;46;49;141;92;136;336;76;133
13.05.2023 15:00;0;285;42;28;59;65;43;108;152;48;43;137;128;141;285;70;124
13.05.2023 16:00;0;238;26;15;50;46;28;139;116;25;30;112;112;105;238;41;96
13.05.2023 17:00;0;280;30;23;54;42;22;115;187;39;40;112;91;146;280;53;96
13.05.2023 18:00;0;272;37;9;50;51;34;94;140;35;31;108;78;162;272;46;101
13.05.2023 19:00;0;256;34;22;43;52;42;91;127;39;23;132;72;137;256;56;95
13.05.2023 20:00;0;169;39;16;38;47;29;65;102;22;28;65;47;91;169;55;85
13.05.2023 21:00;0;122;23;5;36;22;13;46;48;10;20;78;24;54;122;28;58
13.05.2023 22:00;0;109;8;12;27;17;2;19;20;14;21;38;12;32;109;20;44
13.05.2023 23:00;0;63;9;8;12;8;8;10;17;9;8;33;6;11;63;17;20
14.05.2023 00:00;0;74;8;4;15;13;4;3;18;2;8;21;0;13;74;12;28
14.05.2023 01:00;0;69;11;0;9;9;2;3;7;1;8;12;5;5;69;11;18
14.05.2023 02:00;0;48;0;0;2;1;1;2;3;2;1;7;2;5;48;0;3
14.05.2023 03:00;0;19;0;1;2;4;0;1;5;0;1;1;0;0;19;1;6
14.05.2023 04:00;0;11;4;2;2;1;0;1;1;0;3;3;0;0;11;6;3
14.05.2023 05:00;0;10;2;0;0;1;1;3;1;3;4;4;1;2;10;2;1
14.05.2023 06:00;0;16;5;2;8;6;0;8;8;3;2;11;5;4;16;7;14
14.05.2023 07:00;0;40;20;13;11;14;14;19;27;7;8;24;12;27;40;33;25
14.05.2023 08:00;0;113;34;47;44;25;83;54;55;64;48;90;46;72;113;81;69
14.05.2023 09:00;0;253;71;165;86;106;126;238;251;226;21;275;126;259;253;236;192
14.05.2023 10:00;0;330;130;194;128;216;137;480;586;238;47;717;280;506;330;324;344
14.05.2023 11:00;0;304;147;71;219;241;163;653;499;129;61;494;507;477;304;218;460
14.05.2023 12:00;0;317;160;65;224;179;228;421;496;104;57;483;372;462;317;225;403
14.05.2023 13:00;0;354;136;79;200;151;178;427;475;129;66;372;379;443;354;215;351
14.05.2023 14:00;0;347;134;84;204;162;176;385;491;110;59;447;293;429;347;218;366
14.05.2023 15:00;0;269;99;88;145;170;162;333;462;115;54;424;284;411;269;187;315
14.05.2023 16:00;0;271;97;66;157;134;169;282;403;109;65;302;274;369;271;163;291
14.05.2023 17:00;0;306;76;50;159;137;101;268;382;87;55;350;250;348;306;126;296
14.05.2023 18:00;0;299;66;53;137;124;89;176;345;79;64;233;139;308;299;119;261
14.05.2023 19:00;0;217;52;30;98;92;66;124;182;42;25;135;117;160;217;82;190
14.05.2023 20:00;0;158;36;13;38;47;16;75;125;29;26;105;66;109;158;49;85
14.05.2023 21:00;0;104;28;12;22;21;16;36;60;21;18;56;40;48;104;40;43
14.05.2023 22:00;0;79;10;4;45;46;5;13;39;12;14;28;10;41;79;14;91
14.05.2023 23:00;0;27;3;1;12;9;1;6;15;11;5;7;7;17;27;4;21
15.05.2023 00:00;0;20;0;1;2;4;0;3;1;1;1;2;2;2;20;1;6
15.05.2023 01:00;0;5;1;0;2;1;1;7;0;0;0;2;1;0;5;1;3
15.05.2023 02:00;0;3;0;0;1;0;0;0;1;0;0;0;1;1;3;0;1
15.05.2023 03:00;0;3;0;1;4;0;0;0;1;0;2;1;0;0;3;1;4
15.05.2023 04:00;0;11;2;4;5;2;1;3;1;0;3;6;2;1;11;6;7
15.05.2023 05:00;0;39;17;14;18;8;7;11;14;6;15;18;8;10;39;31;26
15.05.2023 06:00;0;155;45;49;85;48;29;49;64;8;45;70;42;54;155;94;133
15.05.2023 07:00;0;372;100;82;183;171;73;154;185;68;132;255;98;199;372;182;354
15.05.2023 08:00;0;425;73;36;226;220;49;199;196;58;126;395;71;172;425;109;446
15.05.2023 09:00;0;266;30;24;109;88;29;82;103;30;71;171;42;103;266;54;197
15.05.2023 10:00;0;177;18;26;38;51;25;65;63;21;49;98;44;59;177;44;89
15.05.2023 11:00;0;196;41;11;51;50;43;64;72;21;53;105;52;66;196;52;101
15.05.2023 12:00;0;278;35;20;66;65;34;91;126;30;73;143;67;106;278;55;131
15.05.2023 13:00;0;367;60;20;98;94;60;110;164;49;73;171;56;157;367;80;192
15.05.2023 14:00;0;395;77;34;101;121;71;122;188;59;76;196;90;177;395;111;222
15.05.2023 15:00;0;459;106;47;173;151;78;180;184;84;118;263;95;186;459;153;324
15.05.2023 16:00;0;628;114;76;211;186;100;213;309;89;128;321;149;264;628;190;397
15.05.2023 17:00;0;678;126;63;246;194;80;214;353;104;128;424;131;320;678;189;440
15.05.2023 18:00;0;633;114;32;191;149;65;171;289;86;80;361;107;290;633;146;340
15.05.2023 19:00;0;433;40;31;112;91;47;136;180;62;72;203;90;213;433;71;203
15.05.2023 20:00;0;228;32;22;61;52;26;66;87;36;43;116;40;90;228;54;113
15.05.2023 21:00;0;189;9;6;33;25;2;25;56;10;34;47;15;51;189;15;58
15.05.2023 22:00;0;97;10;4;23;10;5;6;24;6;16;19;2;15;97;14;33
15.05.2023 23:00;0;54;2;4;7;3;0;4;1;1;12;7;3;5;54;6;10
16.05.2023 00:00;0;14;3;0;2;1;0;0;3;3;4;1;0;1;14;3;3
16.05.2023 01:00;0;4;0;0;2;0;0;0;0;1;1;0;0;1;4;0;2
16.05.2023 02:00;0;1;0;0;2;0;0;1;0;0;0;0;1;0;1;0;2
16.05.2023 03:00;0;0;0;1;4;1;0;0;0;0;1;1;2;0;0;1;5
16.05.2023 04:00;0;8;2;0;5;1;1;1;0;0;0;2;1;0;8;2;6
16.05.2023 05:00;0;21;6;4;13;4;1;6;8;3;15;5;7;3;21;10;17
16.05.2023 06:00;0;83;21;23;27;27;13;17;28;8;32;38;15;24;83;44;54
16.05.2023 07:00;0;331;78;57;145;153;47;97;145;61;103;199;48;167;331;135;298
16.05.2023 08:00;0;409;71;39;244;204;57;163;207;52;117;381;44;179;409;110;448
16.05.2023 09:00;0;280;40;26;111;98;23;73;105;40;59;170;14;114;280;66;209
16.05.2023 10:00;0;257;26;19;64;49;27;41;111;23;42;87;19;73;257;45;113
16.05.2023 11:00;0;289;34;23;49;80;37;60;77;34;58;179;39;100;289;57;129
16.05.2023 12:00;0;296;53;23;61;172;28;74;264;28;73;209;60;229;296;76;233
16.05.2023 13:00;0;349;36;20;86;74;49;110;135;53;68;149;78;144;349;56;160
16.05.2023 14:00;0;368;64;23;93;75;43;96;100;42;84;169;84;100;368;87;168
16.05.2023 15:00;0;394;73;26;124;112;51;143;176;71;84;212;108;146;394;99;236
16.05.2023 16:00;0;596;112;51;153;144;67;137;185;67;118;313;99;176;596;163;297
16.05.2023 17:00;0;645;112;102;218;189;75;196;287;73;104;363;99;258;645;214;407
16.05.2023 18:00;0;595;100;45;161;135;68;143;226;59;112;277;100;256;595;145;296
16.05.2023 19:00;0;413;55;22;100;69;46;80;139;79;71;166;52;159;413;77;169
16.05.2023 20:00;0;237;52;15;74;41;8;43;99;29;48;90;29;97;237;67;115
16.05.2023 21:00;0;180;26;8;37;36;5;35;47;12;20;53;21;65;180;34;73
16.05.2023 22:00;0;152;5;5;30;17;3;13;22;10;32;26;8;22;152;10;47
16.05.2023 23:00;0;60;7;3;3;6;1;5;11;3;13;14;5;9;60;10;9
17.05.2023 00:00;0;25;1;0;3;5;0;2;5;3;12;3;0;0;25;1;8
17.05.2023 01:00;0;8;1;0;3;0;0;1;3;0;2;2;1;1;8;1;3
17.05.2023 02:00;0;11;0;0;1;1;0;0;3;0;2;1;0;3;11;0;2
17.05.2023 03:00;0;9;0;0;3;0;0;0;1;0;1;1;1;0;9;0;3
17.05.2023 04:00;0;12;3;2;7;3;0;3;2;0;3;2;2;2;12;5;10
17.05.2023 05:00;0;38;8;8;23;9;6;11;12;4;16;12;5;8;38;16;32
17.05.2023 06:00;0;144;46;42;74;44;24;37;50;8;50;63;20;44;144;88;118
17.05.2023 07:00;0;357;69;75;177;181;43;122;195;50;123;252;82;197;357;144;358
17.05.2023 08:00;0;394;56;34;246;206;47;176;190;40;104;348;66;157;394;90;452
17.05.2023 09:00;0;243;35;23;84;79;41;65;88;24;57;171;35;83;243;58;163
17.05.2023 10:00;0;194;34;15;48;51;44;64;66;21;44;90;59;72;194;49;99
17.05.2023 11:00;0;258;28;17;59;54;53;86;105;29;40;127;65;104;258;45;113
17.05.2023 12:00;0;332;55;20;54;74;45;114;127;43;71;163;80;123;332;75;128
17.05.2023 13:00;0;378;61;27;98;91;58;131;136;34;88;165;80;126;378;88;189
17.05.2023 14:00;0;369;59;35;90;89;75;125;172;47;72;184;106;157;369;94;179
17.05.2023 15:00;0;466;87;42;172;128;64;199;236;76;86;254;125;209;466;129;300
17.05.2023 16:00;0;609;117;60;222;182;92;206;285;80;136;338;148;269;609;177;404
17.05.2023 17:00;0;630;124;72;207;148;93;195;294;86;127;364;147;274;630;196;355
17.05.2023 18:00;0;633;87;46;185;132;58;180;286;86;98;299;158;293;633;133;317
17.05.2023 19:00;0;514;70;38;123;90;48;111;221;56;65;193;91;239;514;108;213
17.05.2023 20:00;0;289;43;29;63;40;24;66;112;49;46;140;45;137;289;72;103
17.05.2023 21:00;0;297;36;15;55;29;8;42;66;23;29;135;34;93;297;51;84
17.05.2023 22:00;0;214;22;3;48;20;11;17;32;8;26;45;8;34;214;25;68
17.05.2023 23:00;0;164;3;11;31;21;3;12;18;10;21;37;7;19;164;14;52
18.05.2023 00:00;0;118;9;5;10;7;2;9;9;6;12;24;3;11;118;14;17
18.05.2023 01:00;0;61;5;2;8;4;1;7;10;3;5;12;0;4;61;7;12
18.05.2023 02:00;0;36;1;0;0;2;0;1;5;1;7;3;0;7;36;1;2
18.05.2023 03:00;0;19;0;2;1;2;1;1;2;1;1;7;0;1;19;2;3
18.05.2023 04:00;0;14;1;1;2;3;2;0;2;1;1;4;0;2;14;2;5
18.05.2023 05:00;0;17;3;0;3;7;1;3;6;0;1;4;5;5;17;3;10
18.05.2023 06:00;0;17;9;1;12;7;2;9;12;4;5;10;7;11;17;10;19
18.05.2023 07:00;0;35;14;3;12;13;8;9;21;3;5;25;9;26;35;17;25
18.05.2023 08:00;0;90;21;10;24;20;28;55;37;5;13;65;48;29;90;31;44
18.05.2023 09:00;0;134;42;28;70;52;49;93;99;39;21;131;77;91;134;70;122
18.05.2023 10:00;0;238;102;42;113;96;126;274;219;69;26;285;244;252;238;144;209
18.05.2023 11:00;0;282;147;78;137;136;219;407;402;82;40;406;408;348;282;225;273
18.05.2023 12:00;0;297;160;84;182;184;335;475;471;95;68;561;437;450;297;244;366
18.05.2023 13:00;0;355;187;100;273;165;342;499;590;126;70;561;422;592;355;287;438
18.05.2023 14:00;0;375;179;114;284;238;322;572;766;129;73;578;503;605;375;293;522
18.05.2023 15:00;0;403;153;103;308;215;314;505;742;107;74;573;502;647;403;256;523
18.05.2023 16:00;0;421;159;100;328;238;274;572;733;108;60;520;404;609;421;259;566
18.05.2023 17:00;0;372;160;87;294;210;251;395;665;125;40;471;352;599;372;247;504
18.05.2023 18:00;0;368;112;73;239;150;161;358;553;128;57;382;266;492;368;185;389
18.05.2023 19:00;0;276;72;49;159;121;117;232;339;73;62;244;152;373;276;121;280
18.05.2023 20:00;0;224;40;31;111;72;43;139;228;50;34;147;96;228;224;71;183
18.05.2023 21:00;0;173;34;25;74;37;24;60;112;23;22;77;47;110;173;59;111
18.05.2023 22:00;0;142;16;11;45;36;14;15;112;23;12;54;5;106;142;27;81
18.05.2023 23:00;0;68;5;3;23;13;8;2;37;5;11;6;3;26;68;8;36
19.05.2023 00:00;0;30;5;4;10;2;0;2;10;2;12;2;3;9;30;9;12
19.05.2023 01:00;0;10;1;2;0;3;0;0;5;3;0;1;0;2;10;3;3
19.05.2023 02:00;0;10;0;1;3;1;0;0;4;3;1;0;4;2;10;1;4
19.05.2023 03:00;0;2;0;2;2;0;0;2;0;0;0;1;0;0;2;2;2
19.05.2023 04:00;0;9;0;4;6;1;0;1;2;0;2;4;1;2;9;4;7
19.05.2023 05:00;0;36;8;10;14;8;2;8;8;5;11;12;8;6;36;18;22
19.05.2023 06:00;0;61;32;21;42;26;10;21;23;3;36;36;20;27;61;53;68
19.05.2023 07:00;0;180;36;17;78;73;20;62;75;25;52;106;43;72;180;53;151
19.05.2023 08:00;0;212;47;19;100;96;34;109;102;20;57;151;42;79;212;66;196
19.05.2023 09:00;0;257;35;15;94;45;42;91;103;24;46;150;70;117;257;50;139
19.05.2023 10:00;0;262;44;36;56;64;91;180;124;36;43;192;164;119;262;80;120
19.05.2023 11:00;0;319;58;36;80;67;129;228;206;63;78;272;208;216;319;94;147
19.05.2023 12:00;0;414;66;45;132;85;141;251;234;63;87;292;258;245;414;111;217
19.05.2023 13:00;0;442;88;28;99;103;140;288;274;57;97;303;206;265;442;116;202
19.05.2023 14:00;0;474;82;56;132;87;137;283;293;60;74;301;283;283;474;138;219
19.05.2023 15:00;0;543;113;62;172;156;159;336;380;119;97;334;287;377;543;175;328
19.05.2023 16:00;0;521;113;45;169;128;157;353;348;99;92;371;230;336;521;158;297
19.05.2023 17:00;0;558;99;56;178;132;118;232;329;81;92;324;231;336;558;155;310
19.05.2023 18:00;0;434;89;51;161;86;93;205;309;88;88;308;152;277;434;140;247
19.05.2023 19:00;0;386;47;35;91;82;53;121;195;55;72;191;84;196;386;82;173
19.05.2023 20:00;0;242;43;36;66;49;24;102;115;31;30;129;74;144;242;79;115
19.05.2023 21:00;0;186;34;20;41;37;18;75;77;21;33;89;42;90;186;54;78
19.05.2023 22:00;0;167;19;15;27;21;9;32;34;19;27;68;16;30;167;34;48
19.05.2023 23:00;0;159;15;1;28;16;2;11;36;5;16;38;22;33;159;16;44
20.05.2023 00:00;0;55;12;5;5;13;2;7;14;12;19;12;3;17;55;17;18
20.05.2023 01:00;0;49;2;5;9;2;2;1;6;4;0;6;3;5;49;7;11
20.05.2023 02:00;0;25;2;2;2;1;0;2;1;0;2;3;0;3;25;4;3
20.05.2023 03:00;0;14;0;0;4;0;0;0;1;0;2;8;1;1;14;0;4
20.05.2023 04:00;0;10;3;1;3;1;1;2;4;1;2;5;0;2;10;4;4
20.05.2023 05:00;0;15;2;2;8;9;3;0;2;4;10;9;3;0;15;4;17
20.05.2023 06:00;0;30;13;7;21;17;14;10;12;4;6;21;6;11;30;20;38
20.05.2023 07:00;0;28;7;9;45;38;11;18;22;10;12;40;11;20;28;16;83
20.05.2023 08:00;0;82;21;11;50;60;20;36;71;11;25;96;39;48;82;32;110
20.05.2023 09:00;0;157;37;19;98;133;48;83;131;36;46;203;69;106;157;56;231
20.05.2023 10:00;0;244;66;30;172;171;106;170;207;53;52;340;170;153;244;96;343
20.05.2023 11:00;0;262;77;50;185;249;204;292;319;60;57;418;196;218;262;127;434
20.05.2023 12:00;0;331;67;63;183;190;199;285;324;63;63;429;238;324;331;130;373
20.05.2023 13:00;0;312;99;70;231;204;172;307;368;69;76;520;228;258;312;169;435
20.05.2023 14:00;0;365;92;55;169;200;177;305;330;70;59;478;248;299;365;147;369
20.05.2023 15:00;0;357;105;62;196;175;134;244;333;71;66;442;198;279;357;167;371
20.05.2023 16:00;0;305;84;44;137;127;134;248;297;56;49;320;245;264;305;128;264
20.05.2023 17:00;0;340;59;38;134;93;112;210;241;68;62;336;186;230;340;97;227
20.05.2023 18:00;0;297;44;37;72;69;82;181;201;43;37;223;142;184;297;81;141
20.05.2023 19:00;0;248;38;17;68;42;49;94;104;26;39;132;84;145;248;55;110
20.05.2023 20:00;0;142;28;14;39;30;22;60;106;19;24;91;56;92;142;42;69
20.05.2023 21:00;0;129;14;13;46;29;12;73;86;22;29;78;54;95;129;27;75
20.05.2023 22:00;0;128;12;6;29;31;2;30;45;14;16;49;16;48;128;18;60
20.05.2023 23:00;0;82;5;8;21;15;1;10;25;6;4;29;7;23;82;13;36
21.05.2023 00:00;0;67;0;0;7;4;8;8;6;6;8;15;1;8;67;0;11
21.05.2023 01:00;0;53;2;7;5;6;5;5;10;4;4;10;1;12;53;9;11
21.05.2023 02:00;0;34;4;1;5;1;8;1;2;4;3;3;0;2;34;5;6
21.05.2023 03:00;0;9;6;1;4;0;0;0;1;0;0;5;1;0;9;7;4
21.05.2023 04:00;0;5;1;0;1;2;3;2;5;0;1;8;1;5;5;1;3
21.05.2023 05:00;0;17;0;2;3;3;2;2;1;2;1;5;1;3;17;2;6
21.05.2023 06:00;0;12;8;3;7;4;3;6;9;1;5;5;6;6;12;11;11
21.05.2023 07:00;0;24;17;6;12;18;6;8;28;1;11;27;12;18;24;23;30
21.05.2023 08:00;0;54;19;10;27;18;28;31;40;8;19;36;35;35;54;29;45
21.05.2023 09:00;0;106;38;23;44;36;40;58;86;25;27;80;74;64;106;61;80
21.05.2023 10:00;0;215;105;51;115;106;125;232;210;60;38;230;155;218;215;156;221
21.05.2023 11:00;0;236;118;86;117;116;176;298;326;68;41;320;281;265;236;204;233
21.05.2023 12:00;0;287;142;88;190;185;218;405;467;79;57;435;358;433;287;230;375
21.05.2023 13:00;0;327;183;82;207;165;227;436;544;78;79;451;352;476;327;265;372
21.05.2023 14:00;0;396;169;111;228;214;271;454;595;142;82;476;367;544;396;280;442
21.05.2023 15:00;0;367;209;116;263;188;262;472;585;133;74;520;420;606;367;325;451
21.05.2023 16:00;0;386;161;92;246;155;202;445;608;91;62;438;325;546;386;253;401
21.05.2023 17:00;0;433;133;72;199;158;151;302;451;90;89;356;245;429;433;205;357
21.05.2023 18:00;0;291;90;52;128;103;100;237;362;88;54;249;189;346;291;142;231
21.05.2023 19:00;0;248;59;32;105;84;49;159;202;71;43;160;132;209;248;91;189
21.05.2023 20:00;0;184;28;27;60;42;49;93;132;41;38;100;70;144;184;55;102
21.05.2023 21:00;0;128;29;6;32;25;19;56;76;17;12;68;50;87;128;35;57
21.05.2023 22:00;0;72;7;9;27;11;8;10;28;10;16;27;15;26;72;16;38
21.05.2023 23:00;0;40;2;2;7;3;2;5;8;3;11;9;3;9;40;4;10
22.05.2023 00:00;0;14;0;0;3;1;0;1;3;2;1;3;2;7;14;0;4
22.05.2023 01:00;0;10;1;0;2;0;0;1;2;0;3;1;0;1;10;1;2
22.05.2023 02:00;0;5;0;0;4;0;0;0;1;0;3;0;0;1;5;0;4
22.05.2023 03:00;0;3;0;0;2;0;0;1;0;0;3;0;0;0;3;0;2
22.05.2023 04:00;0;13;3;1;6;2;2;1;3;0;5;3;0;2;13;4;8
22.05.2023 05:00;0;42;14;14;17;13;4;6;11;3;18;16;4;9;42;28;30
22.05.2023 06:00;0;113;38;52;88;38;27;37;47;17;58;80;36;59;113;90;126
22.05.2023 07:00;0;402;98;59;203;194;57;156;223;64;115;208;90;206;402;157;397
22.05.2023 08:00;0;405;60;39;222;223;48;178;212;44;118;401;72;181;405;99;445
22.05.2023 09:00;0;239;40;23;78;70;24;96;97;39;60;183;50;100;239;63;148
22.05.2023 10:00;0;197;34;23;73;51;52;81;78;27;58;121;70;80;197;57;124
22.05.2023 11:00;0;232;40;22;51;55;69;111;121;26;63;129;79;120;232;62;106
22.05.2023 12:00;0;312;49;16;84;81;54;123;144;46;84;152;80;116;312;65;165
22.05.2023 13:00;0;328;53;24;118;68;58;112;156;59;77;172;82;156;328;77;186
22.05.2023 14:00;0;337;52;24;108;89;39;119;158;59;86;161;100;174;337;76;197
22.05.2023 15:00;0;434;84;38;158;122;55;166;199;66;90;220;102;183;434;122;280
22.05.2023 16:00;0;598;127;56;228;141;85;187;248;69;118;318;120;227;598;183;369
22.05.2023 17:00;0;663;120;58;227;185;83;211;278;87;120;421;130;272;663;178;412
22.05.2023 18:00;0;639;100;30;181;183;65;192;271;98;104;336;124;318;639;130;364
22.05.2023 19:00;0;448;65;30;92;100;52;111;182;58;68;186;82;256;448;95;192
22.05.2023 20:00;0;289;41;19;74;52;18;55;96;20;39;125;33;114;289;60;126
22.05.2023 21:00;0;197;26;10;44;32;16;39;75;17;31;73;27;90;197;36;76
22.05.2023 22:00;0;135;13;8;27;8;5;18;30;11;25;16;7;33;135;21;35
22.05.2023 23:00;0;39;6;5;9;3;2;1;16;13;14;10;5;14;39;11;12
23.05.2023 00:00;0;18;3;4;4;3;0;1;3;2;5;4;0;4;18;7;7
23.05.2023 01:00;0;13;0;0;2;0;1;0;2;1;5;1;2;0;13;0;2
23.05.2023 02:00;0;4;0;0;2;1;0;1;0;0;3;0;2;0;4;0;3
23.05.2023 03:00;0;2;1;1;4;1;2;0;2;0;4;0;2;0;2;2;5
23.05.2023 04:00;0;7;0;2;4;3;0;2;2;0;3;4;2;1;7;2;7
23.05.2023 05:00;0;45;14;11;23;13;9;9;11;3;21;18;8;11;45;25;36
23.05.2023 06:00;0;125;37;53;75;50;25;45;50;11;49;77;35;48;125;90;125
23.05.2023 07:00;0;405;83;77;184;181;70;139;186;61;123;243;81;197;405;160;365
23.05.2023 08:00;0;447;82;34;244;235;66;179;219;55;136;429;68;176;447;116;479
23.05.2023 09:00;0;238;86;26;95;91;28;79;87;23;72;156;40;65;238;112;186
23.05.2023 10:00;;190;29;13;62;38;23;57;57;16;45;121;65;52;190;42;100
23.05.2023 11:00;;210;24;12;50;37;48;50;66;24;38;104;50;63;210;36;87
23.05.2023 12:00;;255;43;19;45;39;30;54;60;20;49;137;46;76;255;62;84
23.05.2023 13:00;;354;45;14;57;64;36;89;94;34;75;150;58;82;354;59;121
23.05.2023 14:00;;337;63;12;93;71;40;81;96;48;71;125;72;98;337;75;164
23.05.2023 15:00;;401;83;35;157;127;39;142;147;61;97;209;98;185;401;118;284
23.05.2023 16:00;;577;115;46;201;134;57;161;202;69;133;324;106;206;577;161;335
23.05.2023 17:00;;619;110;68;241;186;90;162;254;89;120;402;99;296;619;178;427
23.05.2023 18:00;;575;115;53;154;165;63;139;251;87;113;308;89;287;575;168;319
23.05.2023 19:00;;445;53;32;103;96;29;89;131;53;76;187;77;187;445;85;199
23.05.2023 20:00;;247;51;18;51;52;24;68;99;41;45;96;60;131;247;69;103
23.05.2023 21:00;;215;30;4;52;37;5;42;72;16;31;77;30;75;215;34;89
23.05.2023 22:00;;188;12;5;43;20;2;13;29;8;38;47;10;34;188;17;63
23.05.2023 23:00;;74;4;3;20;3;3;6;13;7;9;16;4;9;74;7;23
24.05.2023 00:00;;22;6;1;3;4;0;3;0;0;6;4;0;0;22;7;7
24.05.2023 01:00;;12;0;0;2;3;0;0;0;0;1;2;0;0;12;0;5
24.05.2023 02:00;;16;0;0;3;0;0;2;3;2;0;1;1;0;16;0;3
24.05.2023 03:00;;2;1;1;4;0;1;0;1;0;1;1;0;0;2;2;4
24.05.2023 04:00;;4;0;2;6;4;0;1;4;1;2;4;2;4;4;2;10
24.05.2023 05:00;;49;18;9;21;12;6;9;8;3;21;12;6;6;49;27;33
24.05.2023 06:00;;119;49;61;97;52;36;37;66;9;58;72;33;56;119;110;149
24.05.2023 07:00;;400;91;94;218;192;71;167;199;67;139;276;90;217;400;185;410
24.05.2023 08:00;;457;97;31;273;262;42;214;245;53;139;463;82;210;457;128;535
24.05.2023 09:00;;320;37;34;111;101;41;116;120;33;79;205;73;117;320;71;212
24.05.2023 10:00;;230;32;19;44;59;33;79;91;23;59;113;72;90;230;51;103
24.05.2023 11:00;;245;32;21;67;65;37;86;124;39;44;119;49;92;245;53;132
24.05.2023 12:00;;280;45;29;72;73;45;74;119;46;72;149;71;108;280;74;145
24.05.2023 13:00;;367;55;28;98;77;83;104;130;41;77;138;72;128;367;83;175
24.05.2023 14:00;;391;58;35;121;97;58;118;118;42;91;182;92;122;391;93;218
24.05.2023 15:00;;451;94;41;164;112;59;132;151;66;129;207;101;157;451;135;276
24.05.2023 16:00;;527;125;59;194;154;46;140;216;63;123;297;83;193;527;184;348
24.05.2023 17:00;;611;118;66;235;192;77;184;279;72;124;402;119;246;611;184;427
24.05.2023 18:00;;597;71;36;162;165;59;149;229;83;92;333;91;242;597;107;327
24.05.2023 19:00;;423;50;39;112;94;39;90;165;33;67;168;55;158;423;89;206
24.05.2023 20:00;;229;25;19;65;52;17;69;87;38;38;115;40;80;229;44;117
24.05.2023 21:00;;205;23;5;56;37;13;36;51;21;31;77;18;61;205;28;93
24.05.2023 22:00;;183;12;3;43;20;2;22;40;14;39;58;13;49;183;15;63
24.05.2023 23:00;;84;4;0;32;17;1;6;16;6;12;19;4;13;84;4;49
25.05.2023 00:00;;26;2;0;4;6;0;5;6;1;3;8;1;1;26;2;10
25.05.2023 01:00;;15;0;0;0;2;0;1;0;0;0;1;1;0;15;0;2
25.05.2023 02:00;;5;0;0;1;1;0;0;0;0;4;2;1;0;5;0;2
25.05.2023 03:00;;2;0;1;4;0;0;1;3;0;4;1;0;0;2;1;4
25.05.2023 04:00;;4;4;3;3;3;0;0;5;0;6;3;1;2;4;7;6
25.05.2023 05:00;;37;14;12;18;10;9;9;12;4;14;14;2;13;37;26;28
25.05.2023 06:00;;132;48;57;82;64;32;39;56;17;52;79;32;47;132;105;146
25.05.2023 07:00;;386;94;77;213;210;56;172;204;90;142;280;99;210;386;171;423
25.05.2023 08:00;;448;85;52;280;206;75;221;227;46;138;442;91;225;448;137;486
25.05.2023 09:00;;264;44;27;117;113;53;109;107;34;76;217;69;108;264;71;230
25.05.2023 10:00;;239;32;26;46;63;58;128;113;34;52;143;115;118;239;58;109
25.05.2023 11:00;;254;62;15;76;47;94;157;131;28;48;204;122;123;254;77;123
25.05.2023 12:00;;338;72;39;78;74;92;148;167;58;103;188;118;151;338;111;152
25.05.2023 13:00;;436;71;26;115;91;85;186;182;37;95;223;132;187;436;97;206
25.05.2023 14:00;;416;67;49;133;102;64;211;191;60;69;218;170;198;416;116;235
25.05.2023 15:00;;511;115;47;206;122;106;185;235;76;124;295;153;237;511;162;328
25.05.2023 16:00;;585;141;60;241;174;104;198;281;105;147;337;156;288;585;201;415
25.05.2023 17:00;;732;148;65;273;217;107;224;359;97;161;441;151;317;732;213;490
25.05.2023 18:00;;696;144;48;224;162;73;188;347;108;107;373;173;354;696;192;386
25.05.2023 19:00;;504;88;52;142;106;51;144;256;83;84;214;85;297;504;140;248
25.05.2023 20:00;;314;58;33;101;91;34;101;195;48;50;142;68;207;314;91;192
25.05.2023 21:00;;293;30;18;62;49;14;56;97;49;50;85;39;124;293;48;111
25.05.2023 22:00;;237;32;13;38;29;11;25;44;20;36;70;8;61;237;45;67
25.05.2023 23:00;;102;5;2;21;4;0;6;20;10;20;22;1;22;102;7;25
26.05.2023 00:00;;50;1;0;8;6;3;4;9;4;10;9;4;6;50;1;14
26.05.2023 01:00;;26;2;1;1;2;1;0;1;1;1;1;1;3;26;3;3
26.05.2023 02:00;;13;0;0;1;0;0;0;0;0;1;0;0;1;13;0;1
26.05.2023 03:00;;3;2;0;5;0;1;1;3;0;0;1;0;0;3;2;5
26.05.2023 04:00;;4;4;5;5;3;1;0;0;1;5;5;1;0;4;9;8
26.05.2023 05:00;;51;17;9;23;12;11;8;15;5;17;19;7;11;51;26;35
26.05.2023 06:00;;120;42;41;58;40;22;35;40;9;56;59;22;36;120;83;98
26.05.2023 07:00;;324;75;73;155;125;60;111;172;63;114;173;63;184;324;148;280
26.05.2023 08:00;;361;68;34;157;147;36;151;142;38;84;287;67;130;361;102;304
26.05.2023 09:00;;260;46;22;96;95;48;100;112;38;68;170;68;107;260;68;191
26.05.2023 10:00;;249;46;29;67;67;59;93;100;26;59;141;72;98;249;75;134
26.05.2023 11:00;;296;40;34;90;58;72;169;156;42;82;161;142;162;296;74;148
26.05.2023 12:00;;394;59;29;120;74;90;192;170;48;97;236;123;175;394;88;194
26.05.2023 13:00;;486;79;44;129;96;83;154;231;68;126;227;123;205;486;123;225
26.05.2023 14:00;;504;92;54;160;114;83;192;264;71;115;250;162;257;504;146;274
26.05.2023 15:00;;496;102;64;149;155;88;207;285;88;97;291;149;249;496;166;304
26.05.2023 16:00;;542;119;49;185;144;107;227;301;65;124;327;167;290;542;168;329
26.05.2023 17:00;;497;74;52;203;157;83;213;301;84;111;306;172;277;497;126;360
26.05.2023 18:00;;521;102;50;158;105;81;171;287;45;101;271;128;245;521;152;263
26.05.2023 19:00;;393;76;33;126;123;47;150;234;71;57;203;99;220;393;109;249
26.05.2023 20:00;;326;39;27;96;79;37;91;188;42;52;221;67;175;326;66;175
26.05.2023 21:00;;201;19;30;53;34;33;56;103;32;41;95;34;102;201;49;87
26.05.2023 22:00;;172;16;11;65;35;3;31;79;21;22;59;24;81;172;27;100
26.05.2023 23:00;;105;10;4;37;23;1;5;33;11;10;25;8;39;105;14;60
27.05.2023 00:00;;65;9;5;22;15;2;11;23;1;10;23;4;11;65;14;37
27.05.2023 01:00;;39;14;1;10;1;1;8;10;2;6;9;2;10;39;15;11
27.05.2023 02:00;;15;3;2;5;2;0;2;2;0;4;3;2;4;15;5;7
27.05.2023 03:00;;11;0;3;2;1;0;0;1;2;1;4;1;2;11;3;3
27.05.2023 04:00;;9;1;1;1;0;0;2;2;0;3;1;0;1;9;2;1
27.05.2023 05:00;;16;4;3;9;5;3;2;4;2;5;6;1;2;16;7;14
27.05.2023 06:00;;21;6;8;12;11;4;12;8;0;9;7;12;10;21;14;23
27.05.2023 07:00;;31;11;7;12;16;10;19;22;6;13;20;12;19;31;18;28
27.05.2023 08:00;;89;33;17;31;27;25;40;50;19;32;56;29;52;89;50;58
27.05.2023 09:00;;174;34;30;58;38;46;104;106;24;59;119;105;100;174;64;96
27.05.2023 10:00;;243;100;52;72;83;106;177;162;64;67;195;141;171;243;152;155
27.05.2023 11:00;;373;79;46;96;103;131;283;274;56;61;291;225;241;373;125;199
27.05.2023 12:00;;375;96;55;173;73;151;253;287;77;74;356;219;320;375;151;246
27.05.2023 13:00;;420;110;76;138;98;155;332;321;86;84;372;275;291;420;186;236
27.05.2023 14:00;;472;120;52;160;135;150;353;362;103;77;361;283;345;472;172;295
27.05.2023 15:00;;450;118;57;184;118;164;318;407;82;92;383;237;377;450;175;302
27.05.2023 16:00;;393;102;43;168;121;152;316;380;83;67;346;261;349;393;145;289
27.05.2023 17:00;;427;74;62;162;95;134;326;331;106;77;330;236;338;427;136;257
27.05.2023 18:00;;439;101;61;140;118;87;221;329;85;62;247;190;344;439;162;258
27.05.2023 19:00;;395;53;34;122;95;93;174;268;63;48;212;126;275;395;87;217
27.05.2023 20:00;;292;53;26;124;61;56;125;242;72;31;115;84;225;292;79;185
27.05.2023 21:00;;194;33;16;86;78;36;62;166;37;22;96;57;181;194;49;164
27.05.2023 22:00;;142;26;5;94;37;39;52;132;22;27;66;34;126;142;31;131
27.05.2023 23:00;;99;10;10;60;33;12;30;53;9;19;31;14;40;99;20;93
28.05.2023 00:00;;66;6;7;34;13;8;9;23;3;14;14;8;26;66;13;47
28.05.2023 01:00;;43;3;3;20;5;1;6;14;3;6;11;3;8;43;6;25
28.05.2023 02:00;;49;0;0;9;2;0;4;14;4;2;4;1;10;49;0;11
28.05.2023 03:00;;21;2;0;7;1;1;5;2;2;3;1;0;2;21;2;8
28.05.2023 04:00;;9;1;0;8;2;0;1;2;0;1;3;0;1;9;1;10
28.05.2023 05:00;;9;2;1;4;9;4;5;4;1;4;9;3;3;9;3;13
28.05.2023 06:00;;17;6;3;12;6;5;11;14;3;1;11;7;9;17;9;18
28.05.2023 07:00;;24;12;10;12;16;11;19;38;3;7;18;13;35;24;22;28
28.05.2023 08:00;;94;26;17;28;30;19;45;48;16;15;58;37;53;94;43;58
28.05.2023 09:00;;86;45;37;66;50;51;107;142;32;29;104;96;117;86;82;116
28.05.2023 10:00;;156;95;55;113;106;125;251;270;52;54;271;244;209;156;150;219
28.05.2023 11:00;;258;137;72;184;123;192;451;407;78;70;394;377;409;258;209;307
28.05.2023 12:00;;316;165;128;237;153;292;538;551;93;70;551;435;450;316;293;390
28.05.2023 13:00;;398;188;106;276;191;304;608;689;124;57;555;469;609;398;294;467
28.05.2023 14:00;;439;195;125;337;198;293;564;728;148;71;555;475;591;439;320;535
28.05.2023 15:00;;495;150;86;316;194;285;555;756;157;89;585;477;635;495;236;510
28.05.2023 16:00;;416;177;125;254;166;286;453;696;137;80;458;413;618;416;302;420
28.05.2023 17:00;;441;148;76;253;178;200;434;567;97;79;486;311;544;441;224;431
28.05.2023 18:00;;356;126;84;249;171;167;319;555;104;60;384;329;520;356;210;420
28.05.2023 19:00;;314;90;62;137;126;116;191;350;85;57;219;163;364;314;152;263
28.05.2023 20:00;;232;70;42;113;80;51;115;221;49;48;165;107;234;232;112;193
28.05.2023 21:00;;186;38;27;89;69;60;74;143;39;18;70;59;163;186;65;158
28.05.2023 22:00;;132;26;13;83;34;18;27;116;26;12;56;20;94;132;39;117
28.05.2023 23:00;;71;23;9;28;4;9;12;32;3;21;22;5;28;71;32;32
29.05.2023 00:00;;42;6;6;11;5;3;6;14;3;5;10;2;11;42;12;16
29.05.2023 01:00;;23;4;0;8;1;1;4;5;3;4;10;0;13;23;4;9
29.05.2023 02:00;;21;2;4;3;2;2;5;5;1;0;1;2;2;21;6;5
29.05.2023 03:00;;15;1;3;3;1;1;1;1;0;2;2;0;1;15;4;4
29.05.2023 04:00;;9;0;0;4;1;0;1;5;1;3;2;0;4;9;0;5
29.05.2023 05:00;;16;4;0;4;6;5;4;6;3;2;5;3;4;16;4;10
29.05.2023 06:00;;13;7;2;16;6;4;8;9;2;5;10;8;5;13;9;22
29.05.2023 07:00;;23;14;6;25;29;18;19;38;4;3;51;9;15;23;20;54
29.05.2023 08:00;;48;24;23;59;34;18;66;57;9;21;58;65;45;48;47;93
29.05.2023 09:00;;131;57;38;68;44;69;112;151;28;22;153;130;140;131;95;112
29.05.2023 10:00;;198;105;53;122;116;142;243;267;53;35;226;247;230;198;158;238
29.05.2023 11:00;;326;194;75;214;123;192;404;433;53;64;439;349;366;326;269;337
29.05.2023 12:00;;381;171;118;243;160;278;551;541;131;70;487;426;510;381;289;403
29.05.2023 13:00;;383;249;110;328;227;304;549;681;148;67;578;468;631;383;359;555
29.05.2023 14:00;;490;202;116;329;244;312;588;809;163;100;634;487;687;490;318;573
29.05.2023 15:00;;412;214;130;273;249;287;517;674;158;74;585;471;612;412;344;522
29.05.2023 16:00;;455;148;100;256;161;201;399;665;148;71;475;358;535;455;248;417
29.05.2023 17:00;;446;143;91;263;212;194;333;662;117;85;437;263;567;446;234;475
29.05.2023 18:00;;411;116;77;203;132;137;264;396;112;44;329;230;432;411;193;335
29.05.2023 19:00;;250;71;54;151;128;71;161;324;68;60;200;162;306;250;125;279
29.05.2023 20:00;;230;50;36;109;63;44;101;235;78;52;147;102;231;230;86;172
29.05.2023 21:00;;155;33;30;83;50;22;75;94;22;22;62;54;99;155;63;133
29.05.2023 22:00;;89;13;7;42;20;3;19;33;8;26;36;14;32;89;20;62
29.05.2023 23:00;;42;6;2;11;13;3;4;11;2;8;7;5;12;42;8;24
30.05.2023 00:00;;17;3;1;5;10;0;0;6;1;7;1;0;5;17;4;15
30.05.2023 01:00;;11;2;3;0;0;0;4;1;0;0;2;0;0;11;5;0
30.05.2023 02:00;;6;0;1;2;1;0;2;1;0;1;2;1;0;6;1;3
30.05.2023 03:00;;2;0;0;1;0;1;0;1;0;2;0;0;1;2;0;1
30.05.2023 04:00;;10;1;7;5;3;0;4;3;0;3;4;2;3;10;8;8
30.05.2023 05:00;;53;12;13;26;9;5;8;10;1;19;15;4;11;53;25;35
30.05.2023 06:00;;138;48;50;105;63;23;39;72;15;63;95;37;65;138;98;168
30.05.2023 07:00;;291;89;47;178;148;58;147;150;50;101;264;76;129;291;136;326
30.05.2023 08:00;;379;72;30;242;256;60;195;226;56;123;405;91;196;379;102;498
30.05.2023 09:00;;270;43;22;123;105;47;122;114;44;65;192;74;113;270;65;228
30.05.2023 10:00;;221;49;28;69;70;54;86;103;44;52;131;98;105;221;77;139
30.05.2023 11:00;;287;44;30;83;64;68;175;141;43;61;165;102;135;287;74;147
30.05.2023 12:00;;333;53;32;111;67;95;126;142;55;60;170;106;146;333;85;178
30.05.2023 13:00;;405;66;40;124;90;72;141;165;55;75;234;125;158;405;106;214
30.05.2023 14:00;;446;80;35;170;111;101;171;253;58;95;250;141;202;446;115;281
30.05.2023 15:00;;476;102;56;197;136;84;225;263;73;113;257;188;253;476;158;333
30.05.2023 16:00;;683;151;61;275;183;110;235;305;108;126;396;167;321;683;212;458
30.05.2023 17:00;;731;127;66;293;244;105;285;388;99;160;502;202;362;731;193;537
30.05.2023 18:00;;629;134;67;214;191;86;238;346;100;118;387;182;374;629;201;405
30.05.2023 19:00;;485;87;54;125;117;47;142;304;82;93;234;124;361;485;141;242
30.05.2023 20:00;;296;54;33;131;86;31;115;191;62;46;130;104;212;296;87;217
30.05.2023 21:00;;241;31;15;76;57;10;85;119;45;45;104;48;145;241;46;133
30.05.2023 22:00;;138;28;8;49;21;8;34;38;11;30;40;15;52;138;36;70
30.05.2023 23:00;;54;11;3;21;9;0;5;15;5;12;18;3;20;54;14;30
31.05.2023 00:00;;22;3;4;3;2;0;2;3;8;7;11;1;9;22;7;5
31.05.2023 01:00;;6;1;0;2;2;0;3;0;2;1;1;1;0;6;1;4
31.05.2023 02:00;;5;0;0;2;1;0;0;1;1;1;0;0;0;5;0;3
31.05.2023 03:00;;4;2;0;3;0;1;0;1;0;2;1;1;0;4;2;3
31.05.2023 04:00;;7;1;3;7;1;0;3;4;1;6;3;2;4;7;4;8
31.05.2023 05:00;;58;25;11;36;14;10;12;16;5;17;28;7;14;58;36;50
31.05.2023 06:00;;157;43;65;104;60;39;67;75;15;75;99;50;62;157;108;164
31.05.2023 07:00;;412;123;89;257;216;60;216;247;72;138;307;125;238;412;212;473
31.05.2023 08:00;;471;99;56;345;325;71;260;290;68;142;512;104;266;471;155;670
31.05.2023 09:00;;287;55;31;139;114;53;120;146;42;75;217;79;132;287;86;253
31.05.2023 10:00;;259;58;36;91;67;60;153;158;40;50;176;114;138;259;94;158
31.05.2023 11:00;;305;59;31;84;69;66;124;197;47;68;170;126;210;305;90;153
31.05.2023 12:00;;340;101;24;123;82;92;220;199;60;82;225;129;190;340;125;205
31.05.2023 13:00;;458;82;41;159;115;105;179;251;62;101;265;179;270;458;123;274
31.05.2023 14:00;;459;91;58;162;103;91;224;272;76;90;262;209;239;459;149;265
31.05.2023 15:00;;559;142;57;252;155;97;261;291;69;155;381;201;284;559;199;407
31.05.2023 16:00;;724;203;93;308;200;164;330;401;101;118;473;202;334;724;296;508
31.05.2023 17:00;;721;212;103;307;249;117;305;436;103;155;518;194;411;721;315;556
31.05.2023 18:00;;701;132;63;251;215;123;279;432;131;113;425;212;447;701;195;466
31.05.2023 19:00;;549;103;57;164;160;71;205;267;83;94;293;115;353;549;160;324
31.05.2023 20:00;;337;63;51;107;65;42;109;220;49;71;215;94;206;337;114;172
31.05.2023 21:00;;275;42;16;74;76;23;105;154;52;46;138;61;190;275;58;150
31.05.2023 22:00;;248;31;20;50;39;7;43;59;17;38;103;25;101;248;51;89
31.05.2023 23:00;;92;1;5;16;16;0;14;24;13;27;25;7;27;92;6;32
01.06.2023 00:00;;38;6;4;12;9;2;10;8;6;7;10;7;11;38;10;21
01.06.2023 01:00;;18;0;0;0;0;0;2;0;0;3;8;0;2;18;0;0
01.06.2023 02:00;;8;2;0;1;1;0;2;0;0;1;2;0;0;8;2;2
01.06.2023 03:00;;5;1;0;3;0;2;0;2;0;2;1;0;0;5;1;3
01.06.2023 04:00;;7;4;4;1;2;2;1;2;0;2;4;2;1;7;8;3
01.06.2023 05:00;;53;20;13;30;13;9;9;13;4;18;21;4;10;53;33;43
01.06.2023 06:00;;161;57;58;95;54;41;55;71;19;81;92;38;71;161;115;149
01.06.2023 07:00;;427;104;84;248;234;76;195;228;82;142;338;118;232;427;188;482
01.06.2023 08:00;;505;106;64;341;297;89;251;286;62;148;511;108;267;505;170;638
01.06.2023 09:00;;268;46;28;107;109;41;127;162;46;72;239;66;150;268;74;216
01.06.2023 10:00;;244;52;32;71;72;75;143;155;48;67;166;107;138;244;84;143
01.06.2023 11:00;;292;67;37;81;67;91;190;165;42;63;214;140;157;292;104;148
01.06.2023 12:00;;333;60;42;108;75;63;177;183;40;89;199;166;190;333;102;183
01.06.2023 13:00;;439;70;20;138;104;80;185;207;55;82;256;161;220;439;90;242
01.06.2023 14:00;;483;73;59;175;116;84;178;213;68;82;251;139;252;483;132;291
01.06.2023 15:00;;553;131;58;217;141;106;246;260;91;150;318;159;249;553;189;358
01.06.2023 16:00;;671;167;77;246;202;109;266;331;91;152;430;167;322;671;244;448
01.06.2023 17:00;;789;130;82;352;275;101;301;436;113;138;459;205;365;789;212;627
01.06.2023 18:00;;718;136;67;220;197;96;228;381;113;148;422;189;358;718;203;417
01.06.2023 19:00;;529;101;50;133;115;50;159;292;88;89;281;102;310;529;151;248
01.06.2023 20:00;;307;67;37;138;87;38;123;179;51;58;167;96;176;307;104;225
01.06.2023 21:00;;292;39;14;96;50;28;65;112;44;73;130;53;124;292;53;146
01.06.2023 22:00;;199;24;10;33;44;7;32;68;33;41;57;19;56;199;34;77
01.06.2023 23:00;;93;7;4;19;15;4;9;25;4;19;36;8;24;93;11;34
02.06.2023 00:00;;33;3;0;9;4;0;2;9;3;10;2;0;7;33;3;13
02.06.2023 01:00;;6;1;0;2;0;0;1;1;0;2;1;0;1;6;1;2
02.06.2023 02:00;;8;0;0;1;0;0;0;0;0;2;0;0;0;8;0;1
02.06.2023 03:00;;5;1;0;5;2;2;0;2;0;1;1;0;0;5;1;7
02.06.2023 04:00;;8;0;4;5;2;1;2;1;3;7;1;2;2;8;4;7
02.06.2023 05:00;;49;15;12;20;9;7;8;14;7;22;21;7;12;49;27;29
02.06.2023 06:00;;136;52;38;71;51;20;51;57;9;65;61;31;43;136;90;122
02.06.2023 07:00;;349;75;75;174;144;55;126;173;67;119;211;92;179;349;150;318
02.06.2023 08:00;;331;57;41;183;157;39;142;160;52;100;264;62;145;331;98;340
02.06.2023 09:00;;253;41;30;88;83;38;86;94;42;79;154;53;90;253;71;171
02.06.2023 10:00;;271;35;16;47;62;48;97;121;32;59;132;68;77;271;51;109
02.06.2023 11:00;;257;39;30;94;51;47;104;145;39;68;167;89;169;257;69;145
02.06.2023 12:00;;348;71;30;102;49;73;149;157;41;84;186;128;162;348;101;151
02.06.2023 13:00;;489;90;47;138;86;66;165;173;78;99;241;111;205;489;137;224
02.06.2023 14:00;;509;98;51;164;134;90;201;197;62;136;229;142;193;509;149;298
02.06.2023 15:00;;557;94;51;181;139;89;259;267;76;103;338;158;270;557;145;320
02.06.2023 16:00;;552;97;55;181;142;82;255;263;66;104;327;173;242;552;152;323
02.06.2023 17:00;;603;118;48;173;154;85;192;296;86;109;331;166;254;603;166;327
02.06.2023 18:00;;536;90;78;191;147;83;179;278;81;117;284;156;283;536;168;338
02.06.2023 19:00;;501;73;37;126;98;57;127;281;70;68;232;128;302;501;110;224
02.06.2023 20:00;;309;62;26;71;84;28;74;196;47;49;128;70;188;309;88;155
02.06.2023 21:00;;226;42;25;92;62;13;82;135;64;55;90;47;141;226;67;154
02.06.2023 22:00;;204;23;21;60;42;7;28;106;33;18;86;8;98;204;44;102
02.06.2023 23:00;;170;12;18;40;24;7;13;63;14;12;31;12;44;170;30;64
03.06.2023 00:00;;91;12;3;22;10;5;6;18;18;9;36;6;22;91;15;32
03.06.2023 01:00;;68;10;15;9;7;0;5;14;5;7;5;3;16;68;25;16
03.06.2023 02:00;;19;13;2;2;4;0;3;8;1;8;12;1;6;19;15;6
03.06.2023 03:00;;18;3;1;1;2;0;3;2;0;6;8;0;1;18;4;3
03.06.2023 04:00;;11;2;2;1;3;0;2;6;0;5;1;2;2;11;4;4
03.06.2023 05:00;;17;9;3;5;2;4;7;7;3;4;11;1;5;17;12;7
03.06.2023 06:00;;25;7;2;15;7;8;17;11;2;9;11;13;11;25;9;22
03.06.2023 07:00;;38;8;12;15;14;13;22;29;6;12;29;10;18;38;20;29
03.06.2023 08:00;;91;25;21;50;34;28;46;74;33;17;84;46;67;91;46;84
03.06.2023 09:00;;194;74;34;76;51;55;68;117;56;41;108;88;122;194;108;127
03.06.2023 10:00;;302;72;34;74;62;86;146;163;45;67;220;116;183;302;106;136
03.06.2023 11:00;;355;101;51;129;122;135;263;272;65;87;275;222;272;355;152;251
03.06.2023 12:00;;406;117;63;149;108;124;320;282;93;88;339;242;319;406;180;257
03.06.2023 13:00;;452;129;76;144;130;175;304;330;114;94;352;287;364;452;205;274
03.06.2023 14:00;;525;142;43;175;105;166;367;410;95;94;425;263;351;525;185;280
03.06.2023 15:00;;560;156;46;190;167;164;300;409;113;177;434;264;385;560;202;357
03.06.2023 16:00;;471;128;57;209;130;117;362;399;96;70;419;294;336;471;185;339
03.06.2023 17:00;;448;106;90;187;146;126;277;335;104;86;387;189;363;448;196;333
03.06.2023 18:00;;536;119;48;161;188;114;275;350;103;80;358;205;338;536;167;349
03.06.2023 19:00;;483;94;37;176;130;78;156;325;76;70;219;115;303;483;131;306
03.06.2023 20:00;;297;72;39;120;121;43;120;233;49;54;234;75;222;297;111;241
03.06.2023 21:00;;212;44;32;93;63;30;66;175;46;26;109;57;198;212;76;156
03.06.2023 22:00;;218;46;28;133;78;28;64;156;26;25;90;35;150;218;74;211
03.06.2023 23:00;;190;36;13;43;34;6;24;67;28;18;52;14;74;190;49;77
04.06.2023 00:00;;98;11;12;30;14;5;13;22;10;8;29;5;29;98;23;44
04.06.2023 01:00;;61;18;4;9;11;0;10;19;5;2;14;5;16;61;22;20
04.06.2023 02:00;;34;0;2;16;4;0;9;12;7;2;4;0;5;34;2;20
04.06.2023 03:00;;22;1;2;4;4;6;6;5;1;3;9;4;9;22;3;8
04.06.2023 04:00;;19;1;4;1;1;0;5;9;1;2;5;3;7;19;5;2
04.06.2023 05:00;;14;0;5;3;4;2;2;5;3;2;5;3;5;14;5;7
04.06.2023 06:00;;19;5;3;6;9;1;9;13;1;;9;9;10;19;8;15
04.06.2023 07:00;;28;15;20;35;15;12;21;33;7;0;32;16;18;28;35;50
04.06.2023 08:00;;59;22;4;34;31;18;52;47;17;3;81;50;52;59;26;65
04.06.2023 09:00;;111;64;47;67;56;70;141;122;26;7;146;111;94;111;111;123
04.06.2023 10:00;;227;94;51;135;98;153;296;262;102;33;325;197;271;227;145;233
04.06.2023 11:00;;245;144;66;187;144;170;348;393;126;54;432;289;375;245;210;331
04.06.2023 12:00;;331;151;101;192;160;201;437;455;100;62;469;369;337;331;252;352
04.06.2023 13:00;;387;167;86;243;179;176;466;503;135;77;496;363;481;387;253;422
04.06.2023 14:00;;473;213;115;292;261;229;470;595;118;68;527;417;526;473;328;553
04.06.2023 15:00;;429;210;128;233;258;248;472;565;139;79;552;409;575;429;338;491
04.06.2023 16:00;;406;186;107;230;220;207;438;506;127;66;499;317;455;406;293;450
04.06.2023 17:00;;467;188;99;240;223;162;424;554;118;96;514;344;505;467;287;463
04.06.2023 18:00;;397;139;102;193;160;128;345;448;89;62;345;254;447;397;241;353
04.06.2023 19:00;;332;89;62;129;142;106;176;323;105;98;250;130;269;332;151;271
04.06.2023 20:00;;214;62;54;96;117;37;122;283;84;79;156;99;262;214;116;213
04.06.2023 21:00;;181;36;37;68;46;16;78;118;45;79;116;48;115;181;73;114
04.06.2023 22:00;;97;10;13;32;22;6;26;48;13;40;50;14;65;97;23;54
04.06.2023 23:00;;52;4;2;14;3;0;9;19;4;3;8;5;15;52;6;17
05.06.2023 00:00;;13;4;3;6;2;0;4;2;2;5;4;0;4;13;7;8
05.06.2023 01:00;;5;1;1;0;1;0;3;1;1;1;2;1;3;5;2;1
05.06.2023 02:00;;2;2;0;3;0;0;5;0;0;0;0;2;1;2;2;3
05.06.2023 03:00;;4;4;0;4;1;0;0;3;0;1;1;0;0;4;4;5
05.06.2023 04:00;;7;3;3;3;3;0;2;3;1;13;5;1;3;7;6;6
05.06.2023 05:00;;45;17;15;27;17;10;15;9;3;22;17;5;8;45;32;44
05.06.2023 06:00;;159;58;59;99;65;36;51;73;13;57;89;37;64;159;117;164
05.06.2023 07:00;;398;96;90;239;225;64;168;205;73;;335;109;221;398;186;464
05.06.2023 08:00;;457;84;63;284;274;62;248;253;58;;538;103;221;457;147;558
05.06.2023 09:00;;287;51;30;116;115;55;129;152;38;;264;61;137;287;81;231
05.06.2023 10:00;;257;38;27;71;57;82;104;133;30;41;160;101;104;257;65;128
05.06.2023 11:00;;292;45;29;81;78;78;166;156;33;209;187;148;163;292;74;159
05.06.2023 12:00;;328;73;33;117;76;77;172;182;48;120;244;145;160;328;106;193
05.06.2023 13:00;;413;106;27;140;120;93;247;212;66;74;251;158;216;413;133;260
05.06.2023 14:00;;454;98;47;120;120;81;162;215;54;154;238;133;214;454;145;240
05.06.2023 15:00;;551;104;49;183;142;110;278;244;66;323;362;200;240;551;153;325
05.06.2023 16:00;;684;159;57;246;155;107;249;316;107;190;420;203;271;684;216;401
05.06.2023 17:00;;770;146;63;294;227;106;293;391;108;132;493;210;392;770;209;521
05.06.2023 18:00;;680;132;61;225;208;82;252;402;123;111;414;175;457;680;193;433
05.06.2023 19:00;;465;92;59;152;133;56;197;284;97;97;286;134;365;465;151;285
05.06.2023 20:00;;324;66;52;71;91;42;126;204;54;69;172;93;199;324;118;162
05.06.2023 21:00;;222;48;19;62;90;18;63;159;66;38;133;51;162;222;67;152
05.06.2023 22:00;;176;27;11;24;40;3;28;77;28;42;55;20;69;176;38;64
05.06.2023 23:00;;91;3;7;15;10;2;4;14;10;12;18;4;22;91;10;25
06.06.2023 00:00;;21;2;0;5;7;4;4;11;7;2;4;0;2;21;2;12
06.06.2023 01:00;;16;1;0;2;1;10;1;2;0;0;6;0;2;16;1;3
06.06.2023 02:00;;4;1;3;0;0;1;0;2;0;2;4;0;3;4;4;0
06.06.2023 03:00;;4;1;0;3;0;1;1;3;2;3;0;0;1;4;1;3
06.06.2023 04:00;;10;4;5;5;5;3;2;4;0;11;6;2;2;10;9;10
06.06.2023 05:00;;45;19;16;32;19;10;9;13;2;31;18;3;11;45;35;51
06.06.2023 06:00;;173;64;51;104;80;27;63;77;14;83;103;40;69;173;115;184
06.06.2023 07:00;;437;147;116;238;229;94;215;229;85;178;365;126;252;437;263;467
06.06.2023 08:00;;549;112;59;339;265;78;279;285;72;100;589;133;255;549;171;604
06.06.2023 09:00;;316;89;29;137;119;39;171;166;57;;271;85;150;316;118;256
06.06.2023 10:00;;250;57;38;98;78;60;196;139;45;;191;146;134;250;95;176
06.06.2023 11:00;;309;44;22;79;68;75;136;143;42;72;186;133;139;309;66;147
06.06.2023 12:00;;390;77;33;113;85;83;196;232;59;77;258;135;221;390;110;198
06.06.2023 13:00;;458;87;43;135;85;88;226;210;80;58;270;168;223;458;130;220
06.06.2023 14:00;;465;96;49;154;120;83;210;241;74;67;288;164;236;465;145;274
06.06.2023 15:00;;550;127;59;195;140;86;243;269;98;100;317;196;282;550;186;335
06.06.2023 16:00;;684;166;77;286;197;113;274;340;98;127;400;148;326;684;243;483
06.06.2023 17:00;;793;170;94;313;229;133;306;399;117;515;548;192;365;793;264;542
06.06.2023 18:00;;679;148;61;227;187;87;250;339;111;137;458;173;380;679;209;414
06.06.2023 19:00;;549;73;51;138;144;53;142;250;85;106;277;111;239;549;124;282
06.06.2023 20:00;;292;68;40;95;88;37;126;178;45;52;197;74;181;292;108;183
06.06.2023 21:00;;241;19;11;62;56;18;66;102;41;50;126;49;130;241;30;118
06.06.2023 22:00;;239;27;14;45;26;9;38;54;14;33;78;20;83;239;41;71
06.06.2023 23:00;;68;4;0;24;8;7;7;13;12;17;15;2;22;68;4;32
07.06.2023 00:00;;36;4;3;5;7;1;1;5;3;;8;2;5;36;7;12
07.06.2023 01:00;;24;1;0;3;3;0;0;0;0;;1;0;1;24;1;6
07.06.2023 02:00;;10;1;0;1;2;0;0;0;1;;1;0;2;10;1;3
07.06.2023 03:00;;3;2;0;4;0;1;0;1;0;;1;0;0;3;2;4
07.06.2023 04:00;;5;2;2;4;4;0;1;3;1;;2;2;4;5;4;8
07.06.2023 05:00;;47;16;14;25;7;9;8;9;3;;21;8;11;47;30;32
07.06.2023 06:00;;142;25;32;75;37;21;40;47;10;;68;25;37;142;57;112
07.06.2023 07:00;;337;64;64;154;170;51;116;149;60;;266;77;179;337;128;324
07.06.2023 08:00;;404;70;35;220;200;40;164;192;48;;418;94;173;404;105;420
07.06.2023 09:00;;245;34;15;89;87;35;91;89;24;;204;56;79;245;49;176
07.06.2023 10:00;;221;24;10;49;48;51;104;92;35;;130;95;98;221;34;97
07.06.2023 11:00;;284;41;19;54;48;51;91;102;28;;148;86;117;284;60;102
07.06.2023 12:00;;305;46;22;60;72;52;107;110;38;;153;83;94;305;68;132
07.06.2023 13:00;;366;43;26;83;80;38;96;114;48;;166;74;135;366;69;163
07.06.2023 14:00;;380;60;24;114;87;37;135;120;58;;189;91;124;380;84;201
07.06.2023 15:00;;375;65;28;132;83;49;138;116;44;;186;91;137;375;93;215
07.06.2023 16:00;;515;100;29;184;143;56;164;191;49;;297;129;185;515;129;327
07.06.2023 17:00;;634;72;42;180;181;50;154;257;67;;380;127;208;634;114;361
07.06.2023 18:00;;625;72;40;160;140;53;163;224;66;;359;104;258;625;112;300
07.06.2023 19:00;;419;67;31;99;123;31;135;187;59;;319;84;204;419;98;222
07.06.2023 20:00;;292;54;19;94;84;31;97;152;26;;272;56;125;292;73;178
07.06.2023 21:00;;203;28;5;70;44;19;64;85;37;;148;39;102;203;33;114
07.06.2023 22:00;;260;22;9;109;53;9;40;102;36;;254;42;83;260;31;162
07.06.2023 23:00;;155;5;8;33;24;8;24;46;14;;82;10;42;155;13;57
08.06.2023 00:00;;89;13;4;14;7;6;13;23;4;;34;4;12;89;17;21
08.06.2023 01:00;;70;2;2;6;10;2;4;9;7;;9;2;14;70;4;16
08.06.2023 02:00;;22;1;0;5;3;2;2;6;2;;7;0;8;22;1;8
08.06.2023 03:00;;18;3;0;2;0;1;1;2;2;;5;1;2;18;3;2
08.06.2023 04:00;;8;2;3;4;3;0;1;2;1;;1;1;3;8;5;7
08.06.2023 05:00;;20;5;1;2;2;2;5;7;3;;12;0;5;20;6;4
08.06.2023 06:00;;20;8;6;11;30;5;12;16;5;;35;14;14;20;14;41
08.06.2023 07:00;;42;27;6;15;19;19;32;38;10;;78;22;27;42;33;34
08.06.2023 08:00;;84;39;25;46;43;40;62;76;12;;140;51;70;84;64;89
08.06.2023 09:00;;187;39;36;62;73;73;170;171;53;;207;141;155;187;75;135
08.06.2023 10:00;;203;122;57;119;97;140;283;295;46;;275;233;254;203;179;216
08.06.2023 11:00;;246;169;118;167;130;254;465;420;80;;373;403;337;246;287;297
08.06.2023 12:00;;348;221;95;235;209;258;476;503;86;;516;463;461;348;316;444
08.06.2023 13:00;;402;169;102;226;168;238;507;532;104;;482;411;474;402;271;394
08.06.2023 14:00;;330;184;117;206;175;244;460;542;115;;409;384;476;330;301;381
08.06.2023 15:00;;279;91;95;167;94;208;241;379;87;;330;218;334;279;186;261
08.06.2023 16:00;;307;169;78;164;121;150;268;351;79;;336;254;290;307;247;285
08.06.2023 17:00;;369;112;42;181;195;138;353;431;93;;359;278;426;369;154;376
08.06.2023 18:00;;364;126;43;215;178;85;388;436;117;;435;246;416;364;169;393
08.06.2023 19:00;;323;70;48;119;68;86;179;251;67;;277;109;276;323;118;187
08.06.2023 20:00;;204;34;29;66;37;33;124;134;28;;132;77;121;204;63;103
08.06.2023 21:00;;142;37;25;65;108;24;93;126;7;;113;33;107;142;62;173
08.06.2023 22:00;;138;13;8;53;117;17;51;212;22;;85;39;185;138;21;170
08.06.2023 23:00;;53;8;1;24;11;0;16;27;6;;41;5;28;53;9;35
09.06.2023 00:00;;34;0;3;2;4;3;4;5;4;;8;3;2;34;3;6
09.06.2023 01:00;;22;3;1;3;4;0;3;6;3;;1;1;4;22;4;7
09.06.2023 02:00;;8;2;2;2;0;0;0;1;0;;3;0;0;8;4;2
09.06.2023 03:00;;5;2;0;3;2;1;2;1;0;;1;1;2;5;2;5
09.06.2023 04:00;;8;3;6;6;2;0;3;5;4;;2;4;5;8;9;8
09.06.2023 05:00;;40;7;7;16;20;5;10;9;3;;15;4;7;40;14;36
09.06.2023 06:00;;100;27;17;54;31;29;41;42;8;;48;31;33;100;44;85
09.06.2023 07:00;;276;64;58;139;116;38;123;142;44;;198;73;119;276;122;255
09.06.2023 08:00;;269;77;34;135;109;51;173;134;25;;261;85;116;269;111;244
09.06.2023 09:00;;283;55;22;82;88;50;122;125;30;;236;113;123;283;77;170
09.06.2023 10:00;;305;59;53;93;73;129;209;173;62;;217;154;178;305;112;166
09.06.2023 11:00;;354;77;50;122;70;125;252;207;47;;259;237;217;354;127;192
09.06.2023 12:00;;418;98;37;109;85;103;227;193;56;;316;223;190;418;135;194
09.06.2023 13:00;;544;107;51;146;103;134;253;258;55;;308;178;256;544;158;249
09.06.2023 14:00;;543;136;54;169;122;141;280;267;78;;320;211;271;543;190;291
09.06.2023 15:00;;576;113;76;128;98;113;294;279;77;;316;248;256;576;189;226
09.06.2023 16:00;;549;113;58;155;117;105;267;303;59;;388;193;285;549;171;272
09.06.2023 17:00;;597;129;42;183;135;107;267;306;89;;387;199;305;597;171;318
09.06.2023 18:00;;552;125;46;239;178;111;298;330;99;;424;198;357;552;171;417
09.06.2023 19:00;;434;100;44;168;149;63;214;272;53;;339;126;254;434;144;317
09.06.2023 20:00;;290;72;31;164;105;51;136;222;56;;240;111;220;290;103;269
09.06.2023 21:00;;250;54;18;128;111;38;163;250;52;;247;119;244;250;72;239
09.06.2023 22:00;;239;24;25;136;102;17;85;246;43;;134;66;229;239;49;238
09.06.2023 23:00;;201;17;6;50;39;8;30;63;28;;39;20;85;201;23;89
10.06.2023 00:00;;125;6;15;20;15;5;15;32;9;;26;11;33;125;21;35
10.06.2023 01:00;;74;4;0;6;6;1;7;14;4;;12;2;14;74;4;12
10.06.2023 02:00;;30;3;0;4;5;0;1;4;0;;7;1;5;30;3;9
10.06.2023 03:00;;17;1;0;4;0;1;1;0;0;;7;0;1;17;1;4
10.06.2023 04:00;;19;1;0;6;2;1;3;3;1;;6;1;1;19;1;8
10.06.2023 05:00;;21;5;4;11;6;1;3;7;6;;7;1;4;21;9;17
10.06.2023 06:00;;22;8;5;17;12;8;20;21;5;18;25;15;14;22;13;29
10.06.2023 07:00;;40;29;12;40;29;19;31;38;8;114;57;21;34;40;41;69
10.06.2023 08:00;;99;34;21;69;38;38;73;76;20;71;126;68;63;99;55;107
10.06.2023 09:00;;209;51;46;75;63;78;127;154;46;50;206;103;139;209;97;138
10.06.2023 10:00;;289;83;53;122;81;138;260;226;57;71;260;238;211;289;136;203
10.06.2023 11:00;;355;98;59;134;83;180;360;238;64;94;354;276;245;355;157;217
10.06.2023 12:00;;399;109;56;114;87;177;333;262;79;89;365;277;266;399;165;201
10.06.2023 13:00;;410;112;48;128;81;133;346;231;58;382;320;261;223;410;160;209
10.06.2023 14:00;;366;101;59;123;81;152;388;275;63;774;383;274;279;366;160;204
10.06.2023 15:00;;409;130;46;161;113;132;419;257;97;298;424;255;251;409;176;274
10.06.2023 16:00;;335;119;47;165;115;137;331;281;58;1179;418;226;266;335;166;280
10.06.2023 17:00;;348;103;72;219;168;130;328;317;80;1054;420;205;290;348;175;387
10.06.2023 18:00;;378;105;58;256;177;120;356;318;79;55;535;223;287;378;163;433
10.06.2023 19:00;;331;109;45;214;154;83;302;299;83;59;378;214;282;331;154;368
10.06.2023 20:00;;263;52;50;271;174;53;218;315;65;50;408;117;275;263;102;445
10.06.2023 21:00;;176;45;33;204;123;52;147;264;52;40;332;115;238;176;78;327
10.06.2023 22:00;;201;35;22;151;83;31;94;154;41;32;185;32;152;201;57;234
10.06.2023 23:00;;175;30;6;234;132;10;103;177;37;29;301;58;122;175;36;366
11.06.2023 00:00;;123;24;13;40;19;10;14;51;29;30;112;17;64;123;37;59
11.06.2023 01:00;;81;6;5;15;5;1;6;17;2;16;18;5;17;81;11;20
11.06.2023 02:00;;35;6;3;8;4;1;2;11;2;10;12;1;9;35;9;12
11.06.2023 03:00;;21;4;0;3;1;2;1;3;0;2;6;1;7;21;4;4
11.06.2023 04:00;;13;0;4;6;2;3;6;6;2;4;3;3;5;13;4;8
11.06.2023 05:00;;22;8;0;3;8;4;3;12;3;8;5;4;6;22;8;11
11.06.2023 06:00;;16;14;7;14;7;5;16;10;3;10;21;9;11;16;21;21
11.06.2023 07:00;;30;44;13;50;32;16;45;61;6;13;75;29;60;30;57;82
11.06.2023 08:00;;68;44;37;59;40;56;90;111;24;25;95;82;105;68;81;99
11.06.2023 09:00;;132;110;44;91;87;97;201;212;50;33;204;173;194;132;154;178
11.06.2023 10:00;;254;131;64;127;122;139;315;284;90;49;316;232;274;254;195;249
11.06.2023 11:00;;241;167;61;146;159;148;337;383;90;65;361;259;340;241;228;305
11.06.2023 12:00;;316;144;86;204;120;228;447;344;85;54;434;325;301;316;230;324
11.06.2023 13:00;;283;154;86;206;122;176;392;329;82;48;418;267;291;283;240;328
11.06.2023 14:00;;372;192;82;232;134;160;406;345;65;50;433;280;312;372;274;366
11.06.2023 15:00;;354;175;70;196;179;121;377;383;97;50;441;308;341;354;245;375
11.06.2023 16:00;;324;127;71;175;168;135;408;342;91;41;411;210;306;324;198;343
11.06.2023 17:00;;321;126;82;227;162;130;389;343;67;61;365;250;312;321;208;389
11.06.2023 18:00;;367;112;63;168;143;107;299;296;77;34;335;186;303;367;175;311
11.06.2023 19:00;;259;99;51;172;118;103;219;290;66;36;341;180;261;259;150;290
11.06.2023 20:00;;247;83;31;165;192;63;188;319;40;36;231;92;277;247;114;357
11.06.2023 21:00;;189;61;39;97;54;51;107;169;43;24;144;102;181;189;100;151
11.06.2023 22:00;;126;23;13;36;24;16;41;57;24;21;76;34;58;126;36;60
11.06.2023 23:00;;74;8;3;7;4;0;13;10;6;18;20;7;21;74;11;11
12.06.2023 00:00;;21;1;2;6;7;0;4;6;8;;4;7;8;21;3;13
12.06.2023 01:00;;19;2;0;0;0;2;5;3;5;;0;2;1;19;2;0
12.06.2023 02:00;;5;2;0;1;1;1;0;0;1;;1;0;0;5;2;2
12.06.2023 03:00;;3;1;1;3;1;2;0;1;0;;0;0;0;3;2;4
12.06.2023 04:00;;20;1;4;13;4;0;3;5;0;;8;3;5;20;5;17
12.06.2023 05:00;;58;17;23;37;18;15;13;20;3;;17;7;20;58;40;55
12.06.2023 06:00;;159;61;65;101;63;43;60;86;17;;116;38;81;159;126;164
12.06.2023 07:00;;454;112;109;258;225;102;209;253;89;;385;126;253;454;221;483
12.06.2023 08:00;;506;88;43;297;253;74;260;292;70;;575;124;265;506;131;550
12.06.2023 09:00;;304;64;28;117;114;50;150;135;35;;260;84;131;304;92;231
12.06.2023 10:00;;285;62;31;63;84;70;131;135;41;;196;97;128;285;93;147
12.06.2023 11:00;;258;65;30;94;71;74;152;145;38;;175;98;158;258;95;165
12.06.2023 12:00;;291;56;27;88;71;54;150;166;51;;183;138;185;291;83;159
12.06.2023 13:00;;427;70;30;120;105;73;165;179;52;;234;136;171;427;100;225
12.06.2023 14:00;;413;98;46;107;114;73;146;175;52;;213;93;181;413;144;221
12.06.2023 15:00;;513;86;49;167;130;88;222;191;63;;268;144;190;513;135;297
12.06.2023 16:00;;641;144;74;270;169;86;240;273;84;;353;144;258;641;218;439
12.06.2023 17:00;;716;162;75;279;211;100;247;318;97;;467;173;278;716;237;490
12.06.2023 18:00;;670;139;50;215;182;74;245;297;106;;467;152;368;670;189;397
12.06.2023 19:00;;478;94;65;155;126;56;176;261;75;;294;122;313;478;159;281
12.06.2023 20:00;;326;81;40;90;85;38;141;196;68;;225;101;221;326;121;175
12.06.2023 21:00;;262;59;45;88;73;33;119;188;45;;207;89;206;262;104;161
12.06.2023 22:00;;211;21;16;67;46;20;73;65;32;;94;29;70;211;37;113
12.06.2023 23:00;;86;12;2;20;15;6;5;18;6;;27;2;25;86;14;35
13.06.2023 00:00;;26;4;12;5;5;1;2;3;6;;7;0;5;26;16;10
13.06.2023 01:00;;8;2;0;3;1;0;0;3;0;;1;1;1;8;2;4
13.06.2023 02:00;;2;2;2;2;0;2;0;2;0;;0;0;2;2;4;2
13.06.2023 03:00;;6;2;3;4;0;0;0;3;1;;4;0;1;6;5;4
13.06.2023 04:00;;11;2;2;3;6;2;1;6;2;;2;2;4;11;4;9
13.06.2023 05:00;;60;25;19;38;18;9;21;21;2;;18;19;19;60;44;56
13.06.2023 06:00;;198;74;61;112;80;38;77;78;11;;127;64;88;198;135;192
13.06.2023 07:00;;451;135;97;258;249;97;258;270;88;;402;131;277;451;232;507
13.06.2023 08:00;;511;104;57;352;289;75;287;311;68;;590;123;270;511;161;641
13.06.2023 09:00;;334;76;39;138;135;61;145;149;56;;290;103;166;334;115;273
13.06.2023 10:00;;287;57;20;100;63;68;135;134;39;;199;93;124;287;77;163
13.06.2023 11:00;;271;80;27;78;59;94;155;128;50;;180;105;127;271;107;137
13.06.2023 12:00;;357;70;31;86;72;64;162;146;49;;201;117;173;357;101;158
13.06.2023 13:00;;452;94;36;113;107;82;135;198;60;;224;111;196;452;130;220
13.06.2023 14:00;;457;79;43;149;112;69;164;200;56;;249;148;177;457;122;261
13.06.2023 15:00;;503;114;57;212;156;86;222;218;87;;290;167;232;503;171;368
13.06.2023 16:00;;617;167;71;246;174;92;241;308;106;;437;168;289;617;238;420
13.06.2023 17:00;;826;158;93;302;245;125;296;365;109;;555;212;338;826;251;547
13.06.2023 18:00;;732;133;78;236;186;99;294;363;128;;451;238;399;732;211;422
13.06.2023 19:00;;599;108;67;140;133;87;253;340;101;;381;176;335;599;175;273
13.06.2023 20:00;;378;109;36;131;123;52;171;293;68;;246;119;316;378;145;254
13.06.2023 21:00;;351;61;38;91;82;37;152;211;51;;185;104;232;351;99;173
13.06.2023 22:00;;277;28;15;76;49;15;61;108;44;;135;40;120;277;43;125
13.06.2023 23:00;;104;12;7;21;13;7;20;29;30;;50;7;33;104;19;34
14.06.2023 00:00;;37;7;0;5;5;3;2;8;4;;7;4;10;37;7;10
14.06.2023 01:00;;14;1;0;5;2;0;0;2;0;;3;0;1;14;1;7
14.06.2023 02:00;;6;1;1;4;1;2;0;1;0;;1;1;1;6;2;5
14.06.2023 03:00;;2;4;0;3;0;0;1;1;0;;1;1;0;2;4;3
14.06.2023 04:00;;16;2;2;7;3;3;3;2;0;;2;4;2;16;4;10
14.06.2023 05:00;;57;22;15;35;16;11;23;17;4;;17;14;20;57;37;51
14.06.2023 06:00;;176;66;72;108;68;45;73;89;16;;120;60;72;176;138;176
14.06.2023 07:00;;412;118;97;262;234;85;209;263;87;;371;116;273;412;215;496
14.06.2023 08:00;;505;107;47;300;293;73;269;306;78;;558;135;256;505;154;593
14.06.2023 09:00;;362;56;30;143;160;53;166;165;57;;278;117;142;362;86;303
14.06.2023 10:00;;276;49;28;86;74;60;140;160;51;;180;119;157;276;77;160
14.06.2023 11:00;;280;55;31;79;69;75;160;193;35;;207;129;159;280;86;148
14.06.2023 12:00;;394;65;28;118;85;87;185;177;52;;229;142;171;394;93;203
14.06.2023 13:00;;407;113;41;122;90;77;185;177;53;;218;145;226;407;154;212
14.06.2023 14:00;;404;74;52;126;131;82;172;201;70;;268;144;170;404;126;257
14.06.2023 15:00;;554;128;51;189;157;96;281;248;80;;325;199;243;554;179;346
14.06.2023 16:00;;660;178;85;293;174;131;260;312;66;;418;159;283;660;263;467
14.06.2023 17:00;;712;189;78;325;261;126;280;474;113;;563;189;405;712;267;586
14.06.2023 18:00;;705;150;82;248;209;84;293;364;114;;424;175;408;705;232;457
14.06.2023 19:00;;560;124;54;184;183;71;197;330;97;;310;137;370;560;178;367
14.06.2023 20:00;;394;87;38;128;130;42;158;260;71;;235;101;266;394;125;258
14.06.2023 21:00;;323;76;26;118;88;33;137;170;44;;202;90;198;323;102;206
14.06.2023 22:00;;307;35;23;87;130;23;80;207;44;;149;41;180;307;58;217
14.06.2023 23:00;;138;15;5;38;17;3;11;45;15;;47;14;42;138;20;55
15.06.2023 00:00;;51;6;3;9;5;3;9;11;1;;15;4;9;51;9;14
15.06.2023 01:00;;18;5;1;1;1;0;3;8;1;;8;2;5;18;6;2
15.06.2023 02:00;;12;3;0;2;0;0;1;0;0;;1;0;0;12;3;2
15.06.2023 03:00;;4;3;1;4;0;1;0;12;1;;1;0;8;4;4;4
15.06.2023 04:00;;12;1;3;4;2;3;0;1;0;;3;3;3;12;4;6
15.06.2023 05:00;;51;27;15;33;25;13;11;13;4;;22;10;10;51;42;58
15.06.2023 06:00;;163;58;61;113;64;25;70;74;14;;113;45;68;163;119;177
15.06.2023 07:00;;423;122;96;222;230;80;199;248;76;;339;121;237;423;218;452
15.06.2023 08:00;;534;105;58;317;266;80;266;293;59;;569;111;263;534;163;583
15.06.2023 09:00;;308;62;41;157;123;63;156;157;31;;269;88;144;308;103;280
15.06.2023 10:00;;272;63;36;74;83;67;146;141;34;;211;128;139;272;99;157
15.06.2023 11:00;;299;49;30;69;72;95;195;140;45;;205;146;161;299;79;141
15.06.2023 12:00;;373;68;41;105;72;76;172;176;58;;224;158;179;373;109;177
15.06.2023 13:00;;439;69;41;134;112;77;156;191;53;;264;132;183;439;110;246
15.06.2023 14:00;;442;97;38;154;128;92;182;199;68;;284;144;216;442;135;282
15.06.2023 15:00;;545;109;51;219;160;93;228;226;77;;355;155;230;545;160;379
15.06.2023 16:00;;689;161;75;230;179;96;252;313;106;;442;190;313;689;236;409
15.06.2023 17:00;;737;122;66;276;215;111;252;341;88;;474;184;307;737;188;491
15.06.2023 18:00;;660;140;79;272;226;121;278;393;107;;499;181;369;660;219;498
15.06.2023 19:00;;593;120;38;147;158;67;212;303;86;;338;135;316;593;158;305
15.06.2023 20:00;;398;93;45;152;103;52;122;217;55;;232;112;214;398;138;255
15.06.2023 21:00;;349;61;41;127;125;44;110;218;55;;244;72;197;349;102;252
15.06.2023 22:00;;261;28;25;92;64;20;74;193;44;;117;36;190;261;53;156
15.06.2023 23:00;;147;18;3;39;28;3;23;36;14;;62;11;48;147;21;67
16.06.2023 00:00;;56;11;7;6;2;2;4;8;5;;12;2;9;56;18;8
16.06.2023 01:00;;25;2;0;7;3;4;1;2;5;;1;5;6;25;2;10
16.06.2023 02:00;;19;0;0;2;0;0;1;3;1;;2;4;2;19;0;2
16.06.2023 03:00;;12;3;0;5;3;0;0;5;0;;4;0;1;12;3;8
16.06.2023 04:00;;19;2;1;4;3;5;4;0;0;;3;5;0;19;3;7
16.06.2023 05:00;;40;17;9;31;21;4;10;14;3;;13;7;14;40;26;52
16.06.2023 06:00;;146;43;46;69;53;33;57;67;16;;78;47;63;146;89;122
16.06.2023 07:00;;316;88;70;176;152;68;180;169;62;;217;112;160;316;158;328
16.06.2023 08:00;;371;85;33;194;176;48;196;200;59;;347;89;225;371;118;370
16.06.2023 09:00;;294;60;23;107;100;53;131;166;33;;205;82;152;294;83;207
16.06.2023 10:00;;307;59;39;93;96;90;180;166;47;;193;112;146;307;98;189
16.06.2023 11:00;;331;89;53;82;68;89;172;156;44;;204;130;177;331;142;150
16.06.2023 12:00;;439;91;35;94;81;73;213;218;66;;235;151;218;439;126;175
16.06.2023 13:00;;554;98;47;151;100;78;215;213;63;;292;158;261;554;145;251
16.06.2023 14:00;;504;113;65;132;125;89;204;245;87;;284;139;226;504;178;257
16.06.2023 15:00;;506;108;52;232;124;125;235;235;95;;310;172;227;506;160;356
16.06.2023 16:00;;506;111;53;173;148;94;275;306;77;;342;206;274;506;164;321
16.06.2023 17:00;;558;147;50;191;145;94;308;308;63;;374;205;317;558;197;336
16.06.2023 18:00;;548;125;48;175;125;86;207;306;86;;304;139;309;548;173;300
16.06.2023 19:00;;516;105;42;186;143;70;209;306;88;;270;140;309;516;147;329
16.06.2023 20:00;;389;82;40;91;104;47;157;236;63;;185;120;237;389;122;195
16.06.2023 21:00;;267;64;37;98;76;56;91;185;41;;147;62;182;267;101;174
16.06.2023 22:00;;326;32;16;101;56;17;83;137;41;;106;40;143;326;48;157
16.06.2023 23:00;;233;32;15;54;49;2;26;85;39;;55;19;105;233;47;103
17.06.2023 00:00;;109;13;8;33;19;3;21;45;17;;37;7;53;109;21;52
17.06.2023 01:00;;69;12;4;19;10;0;2;21;11;;21;1;26;69;16;29
17.06.2023 02:00;;55;1;1;7;7;1;8;8;2;;11;2;8;55;2;14
17.06.2023 03:00;;25;1;0;10;2;0;0;8;1;;6;0;7;25;1;12
17.06.2023 04:00;;21;4;0;1;1;2;3;2;1;;7;2;1;21;4;2
17.06.2023 05:00;;27;6;1;13;7;4;3;6;3;;7;1;2;27;7;20
17.06.2023 06:00;;22;13;9;16;21;9;20;23;4;;37;26;20;22;22;37
17.06.2023 07:00;;51;21;20;31;37;20;37;54;12;;59;26;51;51;41;68
17.06.2023 08:00;;126;45;21;64;71;36;65;102;27;;133;59;86;126;66;135
17.06.2023 09:00;;217;72;55;137;114;68;156;185;41;;198;140;143;217;127;251
17.06.2023 10:00;;326;105;53;113;182;87;278;281;73;;357;211;247;326;158;295
17.06.2023 11:00;;340;92;37;151;172;148;283;267;84;;431;209;269;340;129;323
17.06.2023 12:00;;396;129;55;154;172;135;259;299;81;;484;184;272;396;184;326
17.06.2023 13:00;;472;136;41;206;170;148;313;344;109;;485;243;335;472;177;376
17.06.2023 14:00;;448;129;45;158;131;128;266;249;68;;458;260;235;448;174;289
17.06.2023 15:00;;469;99;65;153;142;146;337;304;72;;441;239;284;469;164;295
17.06.2023 16:00;;422;115;57;142;147;123;271;345;82;;364;240;287;422;172;289
17.06.2023 17:00;;408;122;50;123;133;149;297;371;63;;380;206;317;408;172;256
17.06.2023 18:00;;475;133;56;172;139;116;292;309;75;;334;217;352;475;189;311
17.06.2023 19:00;;452;76;36;126;116;73;256;267;56;;300;149;266;452;112;242
17.06.2023 20:00;;291;74;37;99;82;67;168;249;42;;179;126;228;291;111;181
17.06.2023 21:00;;240;56;27;121;70;51;106;219;55;;170;64;189;240;83;191
17.06.2023 22:00;;225;36;16;69;49;44;106;133;36;;129;50;116;225;52;118
17.06.2023 23:00;;175;37;16;82;48;18;28;66;31;;83;16;93;175;53;130
18.06.2023 00:00;;160;22;1;54;37;5;29;62;8;;72;14;62;160;23;91
18.06.2023 01:00;;99;3;5;28;20;2;13;33;9;;43;3;27;99;8;48
18.06.2023 02:00;;51;2;0;11;7;0;14;15;0;;26;10;10;51;2;18
18.06.2023 03:00;;24;4;3;8;2;1;8;12;4;;10;2;6;24;7;10
18.06.2023 04:00;;12;2;0;4;4;1;3;8;1;;10;2;2;12;2;8
18.06.2023 05:00;;20;2;1;4;8;1;7;3;1;;8;3;2;20;3;12
18.06.2023 06:00;;21;12;5;14;7;9;8;24;1;;11;13;21;21;17;21
18.06.2023 07:00;;36;31;19;24;24;21;28;45;12;;37;25;49;36;50;48
18.06.2023 08:00;;84;40;20;48;32;25;76;84;16;;87;67;74;84;60;80
18.06.2023 09:00;;133;64;37;77;65;109;177;151;32;;164;142;144;133;101;142
18.06.2023 10:00;;216;132;75;135;148;146;336;302;60;;300;284;291;216;207;283
18.06.2023 11:00;;214;147;94;134;129;165;362;333;69;;332;305;315;214;241;263
18.06.2023 12:00;;281;183;93;184;143;187;386;382;76;;415;324;345;281;276;327
18.06.2023 13:00;;296;162;81;193;129;222;351;334;83;;360;279;314;296;243;322
18.06.2023 14:00;;325;156;88;177;132;156;353;373;60;;351;279;330;325;244;309
18.06.2023 15:00;;301;160;75;228;162;125;322;362;85;;376;249;314;301;235;390
18.06.2023 16:00;;323;122;71;193;135;135;295;389;79;;348;260;336;323;193;328
18.06.2023 17:00;;332;105;42;157;179;122;297;307;93;;443;230;258;332;147;336
18.06.2023 18:00;;345;112;52;150;212;87;324;333;60;;389;221;290;345;164;362
18.06.2023 19:00;;302;93;55;102;132;71;216;293;48;;256;124;299;302;148;234
18.06.2023 20:00;;236;49;35;92;68;56;139;163;48;;183;80;205;236;84;160
18.06.2023 21:00;;231;45;16;94;103;22;122;147;37;;408;66;121;231;61;197
18.06.2023 22:00;;128;12;4;37;38;13;29;33;18;;78;27;53;128;16;75
18.06.2023 23:00;;41;3;6;13;6;0;13;13;3;;16;4;12;41;9;19
19.06.2023 00:00;;24;2;1;2;1;0;4;6;2;;5;5;6;24;3;3
19.06.2023 01:00;;6;0;0;2;2;0;0;1;0;;2;0;3;6;0;4
19.06.2023 02:00;;11;0;1;1;1;0;0;1;1;;3;0;3;11;1;2
19.06.2023 03:00;;5;2;0;1;0;2;1;6;1;;13;1;4;5;2;1
19.06.2023 04:00;;15;4;3;10;5;1;2;3;0;;6;6;1;15;7;15
19.06.2023 05:00;;48;13;17;32;14;10;15;19;6;;15;10;14;48;30;46
19.06.2023 06:00;;158;60;67;96;58;31;77;75;13;;97;58;67;158;127;154
19.06.2023 07:00;;431;111;109;233;190;74;179;204;68;;329;111;229;431;220;423
19.06.2023 08:00;;504;100;51;334;362;53;250;356;66;;436;151;322;504;151;696
19.06.2023 09:00;;303;56;32;113;134;40;163;156;46;;245;90;134;303;88;247
19.06.2023 10:00;;236;38;22;70;58;73;109;102;30;;150;67;105;236;60;128
19.06.2023 11:00;;244;86;25;89;52;57;148;127;34;;170;126;140;244;111;141
19.06.2023 12:00;;340;74;24;97;99;39;131;167;45;;203;97;151;340;98;196
19.06.2023 13:00;;393;64;30;122;205;71;131;252;50;;229;106;229;393;94;327
19.06.2023 14:00;;414;71;45;119;102;90;147;138;43;;222;120;127;414;116;221
19.06.2023 15:00;;474;97;36;172;129;58;202;185;81;;292;153;165;474;133;301
19.06.2023 16:00;;649;128;63;270;143;85;243;268;77;;344;127;270;649;191;413
19.06.2023 17:00;;752;139;58;250;188;78;267;337;106;;462;198;297;752;197;438
19.06.2023 18:00;;677;121;41;211;214;85;251;318;111;;513;171;363;677;162;425
19.06.2023 19:00;;488;92;41;144;125;51;169;258;91;;349;105;316;488;133;269
19.06.2023 20:00;;337;70;23;113;110;37;143;208;56;;210;93;209;337;93;223
19.06.2023 21:00;;288;50;31;84;96;27;92;144;55;;313;61;142;288;81;180
19.06.2023 22:00;;245;16;10;49;46;24;63;88;21;;190;43;93;245;26;95
19.06.2023 23:00;;100;11;9;9;19;6;8;24;11;;65;7;17;100;20;28
20.06.2023 00:00;;32;4;4;4;6;0;6;11;5;;13;0;7;32;8;10
20.06.2023 01:00;;16;2;1;2;2;0;0;9;2;;4;0;9;16;3;4
20.06.2023 02:00;;4;0;0;0;1;0;2;4;0;;3;0;0;4;0;1
20.06.2023 03:00;;1;6;0;3;2;1;0;2;1;;2;0;0;1;6;5
20.06.2023 04:00;;13;2;5;3;5;1;4;3;1;;8;3;2;13;7;8
20.06.2023 05:00;;37;17;10;29;21;11;8;17;3;;15;6;11;37;27;50
20.06.2023 06:00;;154;58;60;92;59;30;57;64;11;;91;41;55;154;118;151
20.06.2023 07:00;;399;110;72;219;187;73;162;208;65;;314;91;199;399;182;406
20.06.2023 08:00;;522;103;57;307;307;104;206;338;66;;508;107;278;522;160;614
20.06.2023 09:00;;323;82;30;146;114;58;190;145;66;;273;97;166;323;112;260
20.06.2023 10:00;;249;43;57;89;74;99;151;130;44;;170;106;122;249;100;163
20.06.2023 11:00;;279;65;30;102;66;68;188;140;52;;205;124;167;279;95;168
20.06.2023 12:00;;336;79;23;93;93;55;151;161;51;;240;118;154;336;102;186
20.06.2023 13:00;;414;107;43;120;126;75;185;163;56;;239;129;155;414;150;246
20.06.2023 14:00;;417;60;31;129;105;68;132;139;70;;221;112;130;417;91;234
20.06.2023 15:00;;499;102;41;180;118;87;168;157;68;;257;111;161;499;143;298
20.06.2023 16:00;;582;147;70;227;151;63;189;234;90;;347;144;209;582;217;378
20.06.2023 17:00;;652;116;76;245;241;79;211;299;88;;418;126;296;652;192;486
20.06.2023 18:00;;562;126;38;194;186;70;216;251;72;;406;137;261;562;164;380
20.06.2023 19:00;;420;68;32;118;129;34;146;179;52;;258;81;203;420;100;247
20.06.2023 20:00;;288;55;27;96;74;23;87;131;58;;145;72;158;288;82;170
20.06.2023 21:00;;197;23;18;82;67;25;56;101;29;;96;25;118;197;41;149
20.06.2023 22:00;;197;21;12;86;81;10;54;118;25;;153;25;79;197;33;167
20.06.2023 23:00;;154;10;8;41;34;1;15;48;9;;43;10;40;154;18;75
21.06.2023 00:00;;86;2;3;12;24;0;8;34;5;;10;2;33;86;5;36
21.06.2023 01:00;;55;3;0;7;13;0;3;14;3;;5;4;16;55;3;20
21.06.2023 02:00;;42;0;1;3;0;2;1;3;1;;2;1;1;42;1;3
21.06.2023 03:00;;25;3;1;3;1;1;0;1;1;;2;1;0;25;4;4
21.06.2023 04:00;;18;4;4;8;8;1;6;8;1;;5;4;5;18;8;16
21.06.2023 05:00;;45;20;10;21;18;14;21;15;4;;27;11;15;45;30;39
21.06.2023 06:00;;151;71;62;102;71;31;59;71;14;;114;48;68;151;133;173
21.06.2023 07:00;;420;115;103;247;191;83;197;221;88;;336;101;238;420;218;438
21.06.2023 08:00;;504;103;52;280;267;66;219;274;65;;437;120;229;504;155;547
21.06.2023 09:00;;303;89;36;108;116;56;136;163;41;;234;73;155;303;125;224
21.06.2023 10:00;;307;53;26;85;80;71;140;108;38;;182;123;116;307;79;165
21.06.2023 11:00;;271;54;21;74;63;47;146;154;57;;184;99;185;271;75;137
21.06.2023 12:00;;346;54;30;107;85;56;160;147;41;;232;141;157;346;84;192
21.06.2023 13:00;;384;79;34;108;86;72;159;167;67;;210;94;153;384;113;194
21.06.2023 14:00;;367;76;36;100;89;66;161;175;45;;208;122;157;367;112;189
21.06.2023 15:00;;395;95;38;157;120;56;183;180;66;;215;150;171;395;133;277
21.06.2023 16:00;;600;75;48;216;157;79;166;243;61;;335;113;221;600;123;373
21.06.2023 17:00;;667;140;63;271;196;90;218;286;82;;395;122;254;667;203;467
21.06.2023 18:00;;616;108;48;191;177;86;238;277;92;;378;139;283;616;156;368
21.06.2023 19:00;;457;68;26;135;117;65;180;239;74;;275;135;277;457;94;252
21.06.2023 20:00;;344;70;32;90;68;37;146;185;55;;206;110;204;344;102;158
21.06.2023 21:00;;251;28;16;87;47;23;112;137;32;;133;79;167;251;44;134
21.06.2023 22:00;;224;30;19;64;43;12;77;87;20;;111;39;100;224;49;107
21.06.2023 23:00;;139;7;4;28;19;11;18;47;14;;52;11;72;139;11;47
22.06.2023 00:00;;50;7;6;12;5;5;2;16;13;;10;1;21;50;13;17
22.06.2023 01:00;;18;6;0;4;3;1;4;2;1;;5;3;3;18;6;7
22.06.2023 02:00;;13;6;0;1;1;0;0;1;0;;1;1;2;13;6;2
22.06.2023 03:00;;9;2;1;2;0;0;1;4;0;;2;0;1;9;3;2
22.06.2023 04:00;;25;3;3;6;4;0;1;2;1;;1;2;3;25;6;10
22.06.2023 05:00;;35;12;10;21;11;6;11;7;3;;13;4;12;35;22;32
22.06.2023 06:00;;97;34;32;53;36;24;34;44;8;;58;29;41;97;66;89
22.06.2023 07:00;;215;53;47;125;104;36;98;105;32;;184;51;94;215;100;229
22.06.2023 08:00;;383;74;47;166;172;33;139;188;50;;313;78;160;383;121;338
22.06.2023 09:00;;261;48;26;106;74;40;94;124;34;;152;64;128;261;74;180
22.06.2023 10:00;;242;37;21;46;44;35;85;103;32;;97;61;93;242;58;90
22.06.2023 11:00;;270;42;19;60;66;48;92;102;45;;145;62;116;270;61;126
22.06.2023 12:00;;261;34;19;63;46;19;62;77;15;;97;62;73;261;53;109
22.06.2023 13:00;;189;22;7;44;29;13;29;30;6;;49;21;26;189;29;73
22.06.2023 14:00;;247;35;18;93;31;17;31;66;27;;120;30;60;247;53;124
22.06.2023 15:00;;313;50;20;70;74;29;71;106;40;;151;57;113;313;70;144
22.06.2023 16:00;;333;75;30;104;78;29;65;120;30;;152;55;119;333;105;182
22.06.2023 17:00;;325;52;22;71;76;20;54;86;32;;141;29;75;325;74;147
22.06.2023 18:00;;364;53;19;101;62;25;68;117;23;;169;34;143;364;72;163
22.06.2023 19:00;;263;25;13;57;37;24;43;67;27;;104;28;68;263;38;94
22.06.2023 20:00;;204;23;8;45;39;18;40;66;10;;55;36;71;204;31;84
22.06.2023 21:00;;130;11;12;22;23;11;32;29;12;;34;27;32;130;23;45
22.06.2023 22:00;;116;10;1;16;4;3;7;17;3;;27;8;16;116;11;20
22.06.2023 23:00;;34;3;3;10;4;0;0;7;1;;3;0;5;34;6;14
23.06.2023 00:00;;22;2;0;5;4;3;1;1;0;;4;3;0;22;2;9
23.06.2023 01:00;;14;0;0;2;2;0;0;0;0;;2;0;1;14;0;4
23.06.2023 02:00;;3;0;0;1;1;0;0;1;2;;1;0;1;3;0;2
23.06.2023 03:00;;4;0;0;2;0;0;0;2;0;;1;0;1;4;0;2
23.06.2023 04:00;;11;2;3;3;4;0;2;5;1;;3;3;3;11;5;7
23.06.2023 05:00;;43;12;12;19;11;6;9;14;2;;18;4;11;43;24;30
23.06.2023 06:00;;119;46;35;79;42;29;36;62;13;;62;24;47;119;81;121
23.06.2023 07:00;;246;70;71;120;97;52;99;116;33;;165;55;129;246;141;217
23.06.2023 08:00;;345;69;36;151;145;33;135;189;50;;251;63;157;345;105;296
23.06.2023 09:00;;292;51;20;103;81;30;65;110;37;;191;53;97;292;71;184
23.06.2023 10:00;;224;42;25;54;46;61;103;108;40;;129;80;113;224;67;100
23.06.2023 11:00;;333;67;29;63;59;69;111;135;44;;147;115;151;333;96;122
23.06.2023 12:00;;415;77;35;114;77;69;158;174;50;;191;134;152;415;112;191
23.06.2023 13:00;;490;93;36;119;72;63;176;181;51;;238;123;176;490;129;191
23.06.2023 14:00;;493;106;58;131;104;95;176;200;71;;266;144;211;493;164;235
23.06.2023 15:00;;517;144;60;164;138;108;259;255;71;;327;188;266;517;204;302
23.06.2023 16:00;;582;132;69;202;149;125;254;280;73;;359;201;276;582;201;351
23.06.2023 17:00;;597;106;66;181;152;114;281;363;81;;400;185;352;597;172;333
23.06.2023 18:00;;568;97;71;187;127;106;217;286;77;;323;142;311;568;168;314
23.06.2023 19:00;;480;105;50;122;133;72;201;272;82;;232;158;302;480;155;255
23.06.2023 20:00;;351;61;40;90;77;54;115;238;66;;152;89;234;351;101;167
23.06.2023 21:00;;217;41;20;74;69;33;87;163;47;;135;81;161;217;61;143
23.06.2023 22:00;;192;24;31;75;49;15;64;106;45;;108;42;133;192;55;124
23.06.2023 23:00;;201;14;15;43;36;14;26;52;20;;52;21;65;201;29;79
24.06.2023 00:00;;115;11;6;29;15;4;19;33;11;;32;12;32;115;17;44
24.06.2023 01:00;;79;10;5;10;5;0;8;19;15;;26;4;20;79;15;15
24.06.2023 02:00;;43;3;5;4;2;2;3;5;1;;6;5;15;43;8;6
24.06.2023 03:00;;40;4;0;13;2;1;5;7;2;;12;3;6;40;4;15
24.06.2023 04:00;;9;2;0;9;0;2;2;0;4;;3;3;1;9;2;9
24.06.2023 05:00;;24;6;5;10;7;4;5;9;3;;9;1;7;24;11;17
24.06.2023 06:00;;24;8;9;16;6;8;20;14;4;;22;7;14;24;17;22
24.06.2023 07:00;;60;19;9;18;15;16;25;35;12;;37;18;36;60;28;33
24.06.2023 08:00;;102;27;27;52;37;29;60;84;16;;78;42;79;102;54;89
24.06.2023 09:00;;179;82;41;92;61;75;160;148;53;;161;112;150;179;123;153
24.06.2023 10:00;;326;108;54;88;104;116;211;196;47;;258;192;189;326;162;192
24.06.2023 11:00;;362;108;52;101;100;147;290;254;79;;316;228;292;362;160;201
24.06.2023 12:00;;399;112;57;151;96;151;271;334;71;;343;226;303;399;169;247
24.06.2023 13:00;;424;136;55;123;112;166;310;271;69;;304;251;263;424;191;235
24.06.2023 14:00;;401;136;54;136;118;138;346;292;50;;369;287;275;401;190;254
24.06.2023 15:00;;405;122;64;140;86;117;300;317;69;;334;196;288;405;186;226
24.06.2023 16:00;;378;103;60;129;103;140;284;298;77;;319;235;284;378;163;232
24.06.2023 17:00;;379;127;66;171;115;139;259;336;65;;318;221;274;379;193;286
24.06.2023 18:00;;389;99;74;183;125;99;293;316;71;;316;164;271;389;173;308
24.06.2023 19:00;;371;63;39;119;77;90;239;265;62;;253;166;277;371;102;196
24.06.2023 20:00;;299;65;38;96;73;37;183;221;54;;198;109;201;299;103;169
24.06.2023 21:00;;206;58;45;112;78;35;115;179;55;;124;88;191;206;103;190
24.06.2023 22:00;;185;50;13;78;50;29;64;154;38;;132;47;135;185;63;128
24.06.2023 23:00;;125;25;11;69;34;8;32;102;41;;80;38;128;125;36;103
25.06.2023 00:00;;115;7;5;26;16;11;16;54;27;;38;15;51;115;12;42
25.06.2023 01:00;;77;6;5;17;8;0;13;24;4;;15;7;27;77;11;25
25.06.2023 02:00;;45;4;0;12;4;2;4;17;3;;7;2;17;45;4;16
25.06.2023 03:00;;30;5;0;7;0;1;2;7;0;;6;3;8;30;5;7
25.06.2023 04:00;;7;2;1;3;2;0;7;13;1;;7;3;2;7;3;5
25.06.2023 05:00;;21;1;7;7;4;3;4;7;5;;6;2;8;21;8;11
25.06.2023 06:00;;24;12;6;15;7;4;21;21;4;;23;12;20;24;18;22
25.06.2023 07:00;;34;32;17;23;30;27;26;46;11;;50;27;45;34;49;53
25.06.2023 08:00;;74;47;37;53;38;47;106;137;19;;111;96;116;74;84;91
25.06.2023 09:00;;140;81;63;106;76;72;188;208;42;;180;162;190;140;144;182
25.06.2023 10:00;;214;128;65;147;102;187;280;308;99;;273;235;292;214;193;249
25.06.2023 11:00;;262;163;56;178;136;196;352;343;68;;375;284;321;262;219;314
25.06.2023 12:00;;280;162;67;158;114;196;380;381;74;;386;272;369;280;229;272
25.06.2023 13:00;;275;138;89;204;134;172;347;324;67;;327;309;296;275;227;338
25.06.2023 14:00;;299;158;95;210;144;179;354;362;80;;420;277;338;299;253;354
25.06.2023 15:00;;269;126;70;174;121;175;345;354;88;;326;245;327;269;196;295
25.06.2023 16:00;;263;152;66;175;151;149;271;359;67;;354;233;338;263;218;326
25.06.2023 17:00;;276;144;99;176;115;127;272;320;77;;305;222;315;276;243;291
25.06.2023 18:00;;314;123;74;157;110;116;256;304;65;;320;231;301;314;197;267
25.06.2023 19:00;;278;105;64;112;112;116;242;267;64;;267;164;278;278;169;224
25.06.2023 20:00;;219;84;56;124;82;45;191;251;68;;185;150;229;219;140;206
25.06.2023 21:00;;164;77;44;76;88;32;148;167;47;;160;106;154;164;121;164
25.06.2023 22:00;;98;26;31;42;28;24;53;102;24;;88;26;102;98;57;70
25.06.2023 23:00;;48;12;6;16;7;6;19;16;13;;36;11;21;48;18;23
26.06.2023 00:00;;22;8;2;2;4;3;3;5;3;;9;2;8;22;10;6
26.06.2023 01:00;;11;1;0;2;1;0;2;4;2;;2;0;4;11;1;3
26.06.2023 02:00;;8;1;1;4;1;1;3;3;1;;0;2;3;8;2;5
26.06.2023 03:00;;7;3;1;5;1;0;0;7;0;;1;0;3;7;4;6
26.06.2023 04:00;;11;2;2;3;5;1;4;1;2;;5;3;1;11;4;8
26.06.2023 05:00;;56;22;14;35;16;10;17;12;4;;23;12;12;56;36;51
26.06.2023 06:00;;179;76;72;114;67;41;62;93;23;;104;44;86;179;148;181
26.06.2023 07:00;;363;116;95;222;183;89;170;196;53;;278;116;191;363;211;405
26.06.2023 08:00;;473;96;58;267;251;83;270;275;77;;447;115;230;473;154;518
26.06.2023 09:00;;291;63;37;136;125;59;140;146;57;;244;91;134;291;100;261
26.06.2023 10:00;;248;40;32;65;57;56;135;111;33;;152;73;117;248;72;122
26.06.2023 11:00;;317;55;36;75;70;85;122;134;34;;197;98;131;317;91;145
26.06.2023 12:00;;317;73;37;65;83;66;152;174;54;;188;97;159;317;110;148
26.06.2023 13:00;;372;70;30;120;64;70;161;155;43;;216;87;148;372;100;184
26.06.2023 14:00;;402;57;38;109;86;106;168;182;42;;225;106;165;402;95;195
26.06.2023 15:00;;469;113;52;201;136;78;270;235;70;;274;181;204;469;165;337
26.06.2023 16:00;;677;166;75;295;149;121;242;277;115;;376;167;293;677;241;444
26.06.2023 17:00;;713;134;68;265;237;121;248;338;125;;447;168;332;713;202;502
26.06.2023 18:00;;710;122;61;219;165;84;215;289;110;;317;138;409;710;183;384
26.06.2023 19:00;;446;74;33;135;101;59;170;229;85;;218;113;318;446;107;236
26.06.2023 20:00;;296;71;26;97;60;24;86;140;53;;172;86;134;296;97;157
26.06.2023 21:00;;186;30;20;45;42;20;58;71;32;;98;48;120;186;50;87
26.06.2023 22:00;;162;29;19;41;23;14;24;58;18;;60;19;60;162;48;64
26.06.2023 23:00;;67;15;5;15;11;9;12;12;12;;19;5;21;67;20;26
27.06.2023 00:00;;23;6;1;7;2;2;7;2;0;;5;1;6;23;7;9
27.06.2023 01:00;;11;0;2;2;1;1;0;1;2;;3;0;1;11;2;3
27.06.2023 02:00;;2;0;0;1;1;4;2;1;0;;1;1;0;2;0;2
27.06.2023 03:00;;5;1;1;2;0;1;0;2;0;;1;0;0;5;2;2
27.06.2023 04:00;;9;3;1;2;3;2;3;0;1;;4;2;0;9;4;5
27.06.2023 05:00;;59;29;15;46;23;15;14;22;9;;17;8;18;59;44;69
27.06.2023 06:00;;173;63;76;117;64;32;68;94;25;;126;50;83;173;139;181
27.06.2023 07:00;;365;114;98;225;200;90;177;209;49;;323;89;199;365;212;425
27.06.2023 08:00;;473;125;51;303;290;80;264;351;74;;515;109;285;473;176;593
27.06.2023 09:00;;314;70;38;130;134;72;147;198;51;;243;102;170;314;108;264
27.06.2023 10:00;;247;54;45;73;90;87;148;170;35;;202;148;136;247;99;163
27.06.2023 11:00;;309;50;30;87;81;84;185;184;45;;226;118;166;309;80;168
27.06.2023 12:00;;308;79;29;101;76;74;168;193;55;;218;127;171;308;108;177
27.06.2023 13:00;;366;82;37;108;83;87;167;175;48;;227;102;162;366;119;191
27.06.2023 14:00;;446;88;35;146;83;102;211;193;61;;236;127;186;446;123;229
27.06.2023 15:00;;584;137;45;221;141;93;203;266;87;;303;123;268;584;182;362
27.06.2023 16:00;;702;220;100;291;192;105;199;368;95;;394;152;318;702;320;483
27.06.2023 17:00;;725;161;127;272;271;125;254;407;104;;554;172;362;725;288;543
27.06.2023 18:00;;681;155;72;213;160;107;232;367;107;;381;186;379;681;227;373
27.06.2023 19:00;;532;101;45;134;114;65;189;227;94;;275;121;247;532;146;248
27.06.2023 20:00;;316;76;33;99;68;44;91;156;73;;141;91;157;316;109;167
27.06.2023 21:00;;206;31;25;70;48;13;68;114;32;;99;55;118;206;56;118
27.06.2023 22:00;;154;27;12;42;41;4;43;67;23;;54;29;86;154;39;83
27.06.2023 23:00;;100;11;7;23;11;5;9;17;10;;21;5;18;100;18;34
28.06.2023 00:00;;36;4;0;10;1;5;3;10;3;;11;2;8;36;4;11
28.06.2023 01:00;;10;2;0;10;3;0;2;0;1;;0;2;3;10;2;13
28.06.2023 02:00;;4;2;0;2;0;1;1;1;1;;1;0;3;4;2;2
28.06.2023 03:00;;4;4;0;4;1;1;0;1;1;;0;1;0;4;4;5
28.06.2023 04:00;;11;5;4;7;3;3;4;0;1;;4;1;1;11;9;10
28.06.2023 05:00;;52;26;12;40;19;9;13;18;4;;26;7;16;52;38;59
28.06.2023 06:00;;167;66;59;108;54;31;65;89;17;;113;45;89;167;125;162
28.06.2023 07:00;;348;97;90;204;167;70;179;186;49;;294;90;172;348;187;371
28.06.2023 08:00;;474;95;47;271;256;74;223;266;70;;487;102;241;474;142;527
28.06.2023 09:00;;296;51;22;119;119;49;109;149;47;;209;61;157;296;73;238
28.06.2023 10:00;;237;32;34;75;50;53;117;79;22;;139;95;85;237;66;125
28.06.2023 11:00;;271;36;15;74;59;66;112;143;36;;163;97;144;271;51;133
28.06.2023 12:00;;306;48;34;95;65;48;114;129;47;;163;82;132;306;82;160
28.06.2023 13:00;;379;58;27;134;77;62;132;153;32;;184;100;141;379;85;211
28.06.2023 14:00;;379;72;35;132;88;71;156;147;44;;266;127;161;379;107;220
28.06.2023 15:00;;492;101;43;181;105;97;233;234;65;;263;145;238;492;144;286
28.06.2023 16:00;;666;150;87;253;177;114;260;320;102;;348;166;305;666;237;430
28.06.2023 17:00;;659;143;74;263;222;126;291;391;117;;481;165;384;659;217;485
28.06.2023 18:00;;637;113;64;251;171;97;206;333;103;;394;146;332;637;177;422
28.06.2023 19:00;;463;67;56;122;118;60;152;236;69;;222;124;242;463;123;240
28.06.2023 20:00;;326;59;33;95;87;42;130;159;62;;210;87;181;326;92;182
28.06.2023 21:00;;247;33;39;75;69;30;98;121;44;;145;67;144;247;72;144
28.06.2023 22:00;;225;28;16;72;32;10;56;80;31;;101;31;89;225;44;104
28.06.2023 23:00;;91;12;6;26;13;4;16;38;19;;24;9;27;91;18;39
29.06.2023 00:00;;40;4;1;7;3;0;9;7;0;;8;1;7;40;5;10
29.06.2023 01:00;;17;0;0;5;2;0;2;3;0;;4;2;8;17;0;7
29.06.2023 02:00;;11;2;0;1;0;5;3;1;0;;4;0;2;11;2;1
29.06.2023 03:00;;4;2;1;2;0;1;1;3;0;;2;0;0;4;3;2
29.06.2023 04:00;;11;5;0;5;4;4;2;1;1;;3;2;1;11;5;9
29.06.2023 05:00;;48;23;12;38;12;12;13;13;4;;20;5;15;48;35;50
29.06.2023 06:00;;138;62;54;87;49;36;54;81;11;;97;47;69;138;116;136
29.06.2023 07:00;;347;96;71;199;170;59;133;168;52;;238;85;183;347;167;369
29.06.2023 08:00;;468;81;43;247;266;71;171;236;57;;414;84;240;468;124;513
29.06.2023 09:00;;304;39;29;98;107;48;137;152;46;;222;95;144;304;68;205
29.06.2023 10:00;;258;56;23;79;47;46;116;127;50;;141;94;118;258;79;126
29.06.2023 11:00;;269;47;28;61;48;54;133;98;42;;140;100;106;269;75;109
29.06.2023 12:00;;337;58;38;93;78;67;127;150;48;;214;101;176;337;96;171
29.06.2023 13:00;;358;55;32;106;84;50;172;151;45;;224;124;157;358;87;190
29.06.2023 14:00;;378;57;39;126;79;53;146;157;46;;207;120;148;378;96;205
29.06.2023 15:00;;490;105;42;150;120;62;147;226;66;;261;118;215;490;147;270
29.06.2023 16:00;;654;126;71;232;165;80;167;271;93;;308;148;255;654;197;397
29.06.2023 17:00;;641;101;60;231;156;70;184;279;82;;372;107;264;641;161;387
29.06.2023 18:00;;580;112;38;166;142;82;165;247;74;;309;103;267;580;150;308
29.06.2023 19:00;;384;75;35;103;75;39;135;160;44;;185;94;158;384;110;178
29.06.2023 20:00;;255;53;33;74;70;34;84;125;56;;153;75;149;255;86;144
29.06.2023 21:00;;223;39;27;55;39;35;59;110;38;;90;46;119;223;66;94
29.06.2023 22:00;;187;12;9;52;25;11;39;64;17;;77;20;47;187;21;77
29.06.2023 23:00;;97;8;2;27;17;5;12;19;14;;24;7;37;97;10;44
30.06.2023 00:00;;30;1;1;5;2;5;3;5;2;;8;2;9;30;2;7
30.06.2023 01:00;;17;2;1;5;1;1;0;2;1;;2;1;1;17;3;6
30.06.2023 02:00;;5;1;0;4;2;1;0;0;0;;3;0;0;5;1;6
30.06.2023 03:00;;2;4;0;1;0;0;1;1;0;;0;1;0;2;4;1
30.06.2023 04:00;;4;4;1;3;2;1;1;3;0;;0;1;2;4;5;5
30.06.2023 05:00;;34;6;6;15;8;2;6;8;4;;13;5;6;34;12;23
30.06.2023 06:00;;76;23;25;31;13;14;13;23;5;;28;13;21;76;48;44
30.06.2023 07:00;;168;35;34;61;48;22;44;58;26;;79;28;63;168;69;109
30.06.2023 08:00;;247;49;22;82;91;32;55;96;42;;157;26;80;247;71;173
30.06.2023 09:00;;216;48;15;67;62;84;59;67;17;;147;35;69;216;63;129
30.06.2023 10:00;;225;30;24;35;36;53;67;88;26;;94;84;94;225;54;71
30.06.2023 11:00;;270;50;23;67;35;65;97;116;33;;150;77;128;270;73;102
30.06.2023 12:00;;364;71;36;64;40;74;149;131;31;;172;97;129;364;107;104
30.06.2023 13:00;;392;54;42;96;75;70;132;160;52;;206;113;144;392;96;171
30.06.2023 14:00;;398;96;37;120;122;83;149;217;75;;254;128;207;398;133;242
30.06.2023 15:00;;441;100;43;148;124;113;205;260;63;;368;151;232;441;143;272
30.06.2023 16:00;;509;94;47;161;140;93;212;293;64;;428;165;273;509;141;301
30.06.2023 17:00;;522;91;57;232;158;88;248;332;82;;438;176;303;522;148;390
30.06.2023 18:00;;520;77;62;157;126;58;155;267;99;;303;154;290;520;139;283
30.06.2023 19:00;;408;87;43;174;114;66;164;256;77;;250;130;264;408;130;288
30.06.2023 20:00;;334;43;38;134;139;59;130;324;44;;208;87;295;334;81;273
30.06.2023 21:00;;207;34;24;85;68;24;95;137;31;;146;61;158;207;58;153
30.06.2023 22:00;;191;34;21;72;49;25;76;118;29;;135;31;102;191;55;121
30.06.2023 23:00;;137;15;3;126;57;12;32;98;20;;140;17;74;137;18;183
01.07.2023 00:00;;126;7;3;43;63;7;16;50;14;;242;5;53;126;10;106
01.07.2023 01:00;;73;7;1;13;14;0;6;26;5;;36;5;22;73;8;27
01.07.2023 02:00;;27;2;1;8;7;0;1;10;0;;24;4;8;27;3;15
01.07.2023 03:00;;11;2;3;7;0;0;2;2;0;;4;0;2;11;5;7
01.07.2023 04:00;;6;3;0;2;1;1;1;2;0;;4;1;1;6;3;3
01.07.2023 05:00;;14;5;1;4;3;0;4;4;3;;5;2;5;14;6;7
01.07.2023 06:00;;25;7;8;9;7;4;3;13;0;;12;5;8;25;15;16
01.07.2023 07:00;;40;11;11;13;11;8;10;22;7;;23;14;17;40;22;24
01.07.2023 08:00;;77;30;10;28;19;15;17;44;12;;44;16;42;77;40;47
01.07.2023 09:00;;92;35;9;25;29;24;41;32;27;;62;48;33;92;44;54
01.07.2023 10:00;;137;30;15;32;22;35;36;53;23;;75;19;51;137;45;54
01.07.2023 11:00;;203;33;15;29;24;42;43;80;35;;89;41;73;203;48;53
01.07.2023 12:00;;200;43;15;35;36;43;86;71;31;;102;48;86;200;58;71
01.07.2023 13:00;;259;29;21;72;39;41;69;87;45;;143;56;93;259;50;111
01.07.2023 14:00;;288;22;15;51;52;43;93;88;35;;128;86;94;288;37;103
01.07.2023 15:00;;241;35;17;60;78;33;93;146;41;;255;84;106;241;52;138
01.07.2023 16:00;;219;33;24;71;53;36;105;106;37;;185;56;109;219;57;124
01.07.2023 17:00;;243;43;18;80;76;37;71;118;33;;202;66;102;243;61;156
01.07.2023 18:00;;241;33;23;64;48;39;72;138;26;;170;53;126;241;56;112
01.07.2023 19:00;;232;30;16;50;50;21;87;94;47;;122;41;90;232;46;100
01.07.2023 20:00;;202;20;15;47;52;22;78;91;22;;126;48;78;202;35;99
01.07.2023 21:00;;132;32;18;65;30;23;56;59;18;;76;23;49;132;50;95
01.07.2023 22:00;;126;19;15;37;30;5;17;73;25;;82;21;58;126;34;67
01.07.2023 23:00;;89;10;4;28;32;3;12;47;14;;93;9;45;89;14;60
02.07.2023 00:00;;100;6;3;59;54;1;12;63;6;;330;1;22;100;9;113
02.07.2023 01:00;;44;3;0;10;10;0;2;15;9;;50;8;12;44;3;20
02.07.2023 02:00;;29;5;0;5;3;0;0;3;12;;13;0;6;29;5;8
02.07.2023 03:00;;15;3;0;3;0;0;0;1;0;;6;0;1;15;3;3
02.07.2023 04:00;;10;1;1;1;1;1;3;2;4;;2;2;3;10;2;2
02.07.2023 05:00;;11;2;1;1;5;0;5;5;3;;7;2;3;11;3;6
02.07.2023 06:00;;8;2;5;15;4;6;12;6;3;;12;6;6;8;7;19
02.07.2023 07:00;;32;14;7;31;10;10;32;25;3;;28;13;13;32;21;41
02.07.2023 08:00;;43;22;12;39;26;29;49;44;7;;66;51;44;43;34;65
02.07.2023 09:00;;124;51;30;69;42;42;104;110;31;;106;86;103;124;81;111
02.07.2023 10:00;;163;71;38;107;72;123;165;188;43;;239;130;155;163;109;179
02.07.2023 11:00;;224;100;72;135;139;136;289;303;97;;288;253;276;224;172;274
02.07.2023 12:00;;249;134;73;143;114;191;309;353;61;;336;248;297;249;207;257
02.07.2023 13:00;;278;120;99;158;113;213;319;416;105;;357;279;375;278;219;271
02.07.2023 14:00;;296;128;84;177;165;172;350;391;96;;384;294;343;296;212;342
02.07.2023 15:00;;355;133;100;192;163;222;339;479;105;;399;283;410;355;233;355
02.07.2023 16:00;;289;110;59;194;164;143;345;474;111;;388;301;417;289;169;358
02.07.2023 17:00;;318;113;60;165;146;137;326;384;122;;316;278;330;318;173;311
02.07.2023 18:00;;337;103;68;103;108;106;253;334;76;;224;210;323;337;171;211
02.07.2023 19:00;;233;48;37;92;84;79;125;230;67;;195;126;240;233;85;176
02.07.2023 20:00;;191;36;29;93;64;22;106;149;35;;132;89;152;191;65;157
02.07.2023 21:00;;129;25;12;62;33;13;77;76;21;;84;48;90;129;37;95
02.07.2023 22:00;;63;9;6;26;17;8;22;32;6;;48;22;33;63;15;43
02.07.2023 23:00;;46;4;5;6;5;5;3;16;1;;13;2;10;46;9;11
03.07.2023 00:00;;17;3;3;1;2;1;1;1;2;;2;0;2;17;6;3
03.07.2023 01:00;;12;1;3;1;0;0;4;2;0;;1;1;0;12;4;1
03.07.2023 02:00;;4;4;0;3;0;0;0;1;0;;1;0;1;4;4;3
03.07.2023 03:00;;3;1;0;4;2;1;0;1;0;;1;0;0;3;1;6
03.07.2023 04:00;;9;9;2;7;6;1;0;4;0;;4;1;5;9;11;13
03.07.2023 05:00;;50;19;15;28;18;8;6;22;3;;23;4;17;50;34;46
03.07.2023 06:00;;154;72;63;113;68;30;51;74;20;;99;45;72;154;135;181
03.07.2023 07:00;;341;100;69;191;154;67;151;174;37;;236;88;158;341;169;345
03.07.2023 08:00;;375;76;43;234;221;59;183;234;60;;412;82;237;375;119;455
03.07.2023 09:00;;262;47;14;94;87;40;169;111;30;;237;84;108;262;61;181
03.07.2023 10:00;;204;37;25;58;53;57;118;94;20;;133;86;97;204;62;111
03.07.2023 11:00;;273;47;34;62;57;68;128;114;20;;136;87;109;273;81;119
03.07.2023 12:00;;296;52;45;79;61;53;131;143;46;;180;107;134;296;97;140
03.07.2023 13:00;;348;57;24;82;64;59;178;128;43;;182;123;121;348;81;146
03.07.2023 14:00;;408;53;39;107;70;63;137;142;42;;204;91;133;408;92;177
03.07.2023 15:00;;434;81;34;167;107;64;174;191;59;;231;96;171;434;115;274
03.07.2023 16:00;;691;140;68;232;167;95;233;259;93;;317;140;235;691;208;399
03.07.2023 17:00;;695;129;58;255;169;108;213;341;95;;417;143;310;695;187;424
03.07.2023 18:00;;645;125;72;178;145;96;179;280;105;;349;131;360;645;197;323
03.07.2023 19:00;;407;72;36;124;108;38;169;218;77;;231;106;278;407;108;232
03.07.2023 20:00;;277;58;29;83;79;42;95;162;54;;150;69;182;277;87;162
03.07.2023 21:00;;196;20;14;63;44;21;56;100;46;;99;44;103;196;34;107
03.07.2023 22:00;;147;25;8;37;25;17;36;48;23;;60;12;57;147;33;62
03.07.2023 23:00;;72;9;2;12;12;0;7;21;7;;15;1;23;72;11;24
04.07.2023 00:00;;23;5;1;5;2;0;2;2;2;;1;0;3;23;6;7
04.07.2023 01:00;;16;2;0;0;0;0;0;1;1;;1;0;1;16;2;0
04.07.2023 02:00;;8;4;0;2;0;0;1;1;0;;0;1;0;8;4;2
04.07.2023 03:00;;2;2;0;4;0;1;0;1;3;;1;0;0;2;2;4
04.07.2023 04:00;;8;3;3;4;5;0;0;5;3;;5;1;2;8;6;9
04.07.2023 05:00;;51;26;21;43;20;9;12;17;6;;23;5;15;51;47;63
04.07.2023 06:00;;150;74;59;99;74;35;55;80;18;;111;38;70;150;133;173
04.07.2023 07:00;;357;112;74;231;187;82;156;218;56;;295;90;187;357;186;418
04.07.2023 08:00;;483;98;37;292;281;82;208;271;58;;484;101;217;483;135;573
04.07.2023 09:00;;305;51;30;104;114;47;122;137;53;;245;83;131;305;81;218
04.07.2023 10:00;;267;50;31;83;63;70;154;119;49;;166;77;121;267;81;146
04.07.2023 11:00;;300;43;43;82;49;69;174;180;42;;159;137;159;300;86;131
04.07.2023 12:00;;336;63;35;106;79;88;189;182;40;;225;130;178;336;98;185
04.07.2023 13:00;;409;76;50;112;81;71;195;199;58;;218;129;174;409;126;193
04.07.2023 14:00;;443;82;51;136;87;97;158;231;63;;261;136;199;443;133;223
04.07.2023 15:00;;485;117;48;215;147;119;232;226;67;;343;148;224;485;165;362
04.07.2023 16:00;;653;170;68;273;215;117;251;360;88;;431;189;292;653;238;488
04.07.2023 17:00;;783;145;93;302;279;137;304;433;115;;550;192;393;783;238;581
04.07.2023 18:00;;661;140;69;245;281;101;262;394;111;;560;186;365;661;209;526
04.07.2023 19:00;;440;77;54;204;156;69;178;270;71;;322;104;233;440;131;360
04.07.2023 20:00;;309;49;37;141;108;61;126;214;44;;223;84;198;309;86;249
04.07.2023 21:00;;223;31;19;111;68;26;71;127;41;;196;53;120;223;50;179
04.07.2023 22:00;;243;20;11;119;80;30;54;101;31;;365;27;82;243;31;199
04.07.2023 23:00;;85;3;2;25;10;0;5;23;11;;29;3;23;85;5;35
05.07.2023 00:00;;25;7;1;2;2;0;2;5;3;;14;1;11;25;8;4
05.07.2023 01:00;;9;1;1;2;1;0;0;3;0;;2;0;4;9;2;3
05.07.2023 02:00;;3;1;0;4;1;0;0;4;0;;0;0;2;3;1;5
05.07.2023 03:00;;5;0;0;3;1;0;0;1;1;;2;1;0;5;0;4
05.07.2023 04:00;;8;1;1;2;0;1;1;2;0;;1;3;2;8;2;2
05.07.2023 05:00;;33;6;11;20;12;4;8;3;4;;14;3;5;33;17;32
05.07.2023 06:00;;142;38;34;72;41;24;44;56;10;;61;32;57;142;72;113
05.07.2023 07:00;;282;65;65;171;148;48;112;161;45;;200;58;137;282;130;319
05.07.2023 08:00;;426;88;44;217;191;49;174;200;54;;396;86;188;426;132;408
05.07.2023 09:00;;249;38;24;109;90;29;99;98;33;;177;59;82;249;62;199
05.07.2023 10:00;;200;25;20;52;45;39;71;69;30;;119;47;75;200;45;97
05.07.2023 11:00;;227;37;12;62;47;54;73;67;31;;121;59;68;227;49;109
05.07.2023 12:00;;296;45;13;56;46;39;103;102;25;;137;64;87;296;58;102
05.07.2023 13:00;;261;33;32;76;70;35;108;96;37;;126;88;75;261;65;146
05.07.2023 14:00;;337;56;24;69;69;56;105;80;23;;141;82;81;337;80;138
05.07.2023 15:00;;381;70;29;134;85;45;111;115;46;;221;82;106;381;99;219
05.07.2023 16:00;;483;95;44;168;132;54;147;170;56;;230;85;139;483;139;300
05.07.2023 17:00;;501;77;33;179;130;60;126;198;66;;296;104;173;501;110;309
05.07.2023 18:00;;494;65;33;133;112;39;122;168;65;;253;66;184;494;98;245
05.07.2023 19:00;;333;45;23;107;62;25;82;96;38;;156;53;136;333;68;169
05.07.2023 20:00;;253;39;10;77;46;17;53;83;32;;106;47;87;253;49;123
05.07.2023 21:00;;152;43;13;54;38;16;38;75;20;;93;18;83;152;56;92
05.07.2023 22:00;;133;17;6;32;36;2;27;57;21;;70;13;53;133;23;68
05.07.2023 23:00;;74;7;3;23;9;2;9;15;4;;22;3;16;74;10;32
06.07.2023 00:00;;33;4;3;4;8;0;11;6;0;;9;6;8;33;7;12
06.07.2023 01:00;;8;1;0;3;1;0;1;2;0;;2;1;1;8;1;4
06.07.2023 02:00;;5;0;0;2;2;1;2;3;0;;2;0;2;5;0;4
06.07.2023 03:00;;9;1;0;3;0;0;0;1;0;;3;0;0;9;1;3
06.07.2023 04:00;;11;1;5;4;2;0;0;5;1;;1;2;3;11;6;6
06.07.2023 05:00;;56;21;17;31;13;9;7;15;4;;20;6;11;56;38;44
06.07.2023 06:00;;159;55;68;97;66;23;60;69;10;;91;41;67;159;123;163
06.07.2023 07:00;;306;87;70;188;172;56;145;176;51;;265;75;160;306;157;360
06.07.2023 08:00;;429;106;41;251;228;76;187;251;59;;476;100;223;429;147;479
06.07.2023 09:00;;288;49;29;121;119;67;138;160;39;;210;78;144;288;78;240
06.07.2023 10:00;;238;50;32;78;65;77;160;137;37;;190;101;125;238;82;143
06.07.2023 11:00;;286;73;26;88;69;81;178;198;43;;223;170;182;286;99;157
06.07.2023 12:00;;391;74;38;108;83;92;204;198;50;;246;137;188;391;112;191
06.07.2023 13:00;;352;73;50;116;111;87;168;224;53;;229;156;215;352;123;227
06.07.2023 14:00;;465;96;57;139;80;88;211;234;49;;258;189;210;465;153;219
06.07.2023 15:00;;524;127;61;194;162;97;225;291;76;;351;187;244;524;188;356
06.07.2023 16:00;;655;159;93;234;175;115;296;350;93;;438;184;317;655;252;409
06.07.2023 17:00;;698;160;89;279;234;152;288;413;113;;500;214;414;698;249;513
06.07.2023 18:00;;686;122;84;215;189;105;282;358;93;;414;177;349;686;206;404
06.07.2023 19:00;;479;108;65;190;152;84;184;280;72;;303;133;291;479;173;342
06.07.2023 20:00;;323;76;49;167;103;51;162;255;72;;257;138;261;323;125;270
06.07.2023 21:00;;246;45;35;108;60;20;131;148;45;;180;104;168;246;80;168
06.07.2023 22:00;;206;32;26;98;44;19;58;95;40;;115;37;85;206;58;142
06.07.2023 23:00;;89;7;6;20;18;4;10;27;18;;44;5;25;89;13;38
07.07.2023 00:00;;49;7;1;11;5;5;3;12;3;;7;1;7;49;8;16
07.07.2023 01:00;;15;1;4;6;0;0;3;5;2;;6;0;1;15;5;6
07.07.2023 02:00;;8;1;2;3;2;1;4;3;0;;1;3;1;8;3;5
07.07.2023 03:00;;3;3;0;5;0;0;0;4;0;;2;0;2;3;3;5
07.07.2023 04:00;;10;1;1;2;4;1;0;2;1;;2;1;1;10;2;6
07.07.2023 05:00;;46;19;15;31;14;6;10;13;4;;22;12;14;46;34;45
07.07.2023 06:00;;125;54;53;70;48;26;66;60;19;;82;48;46;125;107;118
07.07.2023 07:00;;277;83;60;151;114;43;109;140;38;;177;65;113;277;143;265
07.07.2023 08:00;;374;69;33;144;141;48;151;188;63;;283;92;175;374;102;285
07.07.2023 09:00;;279;67;43;95;83;66;144;150;38;;188;74;134;279;110;178
07.07.2023 10:00;;277;47;38;87;71;82;163;158;46;;172;115;161;277;85;158
07.07.2023 11:00;;336;72;35;91;66;82;175;187;50;;185;161;172;336;107;157
07.07.2023 12:00;;390;113;36;108;88;82;184;224;50;;239;146;204;390;149;196
07.07.2023 13:00;;432;104;51;131;92;123;175;233;68;;258;166;207;432;155;223
07.07.2023 14:00;;459;120;81;166;122;106;234;247;60;;323;207;214;459;201;288
07.07.2023 15:00;;533;125;70;213;145;121;196;260;79;;320;157;275;533;195;358
07.07.2023 16:00;;498;141;60;198;152;116;278;285;86;;366;195;296;498;201;350
07.07.2023 17:00;;504;113;78;174;194;113;228;301;83;;358;192;276;504;191;368
07.07.2023 18:00;;521;101;47;200;171;142;290;332;95;;469;181;301;521;148;371
07.07.2023 19:00;;436;104;53;162;156;78;199;306;77;;325;192;305;436;157;318
07.07.2023 20:00;;281;77;35;149;114;77;172;293;66;;205;103;233;281;112;263
07.07.2023 21:00;;288;61;27;152;141;51;171;229;51;;227;93;187;288;88;293
07.07.2023 22:00;;256;36;36;163;110;37;100;199;56;;281;71;174;256;72;273
07.07.2023 23:00;;194;23;10;80;41;25;33;126;30;;111;36;116;194;33;121
08.07.2023 00:00;;105;13;6;19;17;7;9;23;12;;45;4;47;105;19;36
08.07.2023 01:00;;65;6;5;15;10;2;4;18;1;;19;4;16;65;11;25
08.07.2023 02:00;;30;3;5;4;10;3;1;6;1;;8;1;6;30;8;14
08.07.2023 03:00;;24;1;3;4;4;0;0;8;2;;6;0;7;24;4;8
08.07.2023 04:00;;20;1;1;3;2;1;0;4;0;;2;0;2;20;2;5
08.07.2023 05:00;;20;3;5;7;6;4;5;6;4;;5;3;1;20;8;13
08.07.2023 06:00;;33;9;7;14;6;7;23;11;1;;32;11;17;33;16;20
08.07.2023 07:00;;43;26;7;25;18;15;26;39;4;;29;29;30;43;33;43
08.07.2023 08:00;;115;37;28;52;32;33;62;98;21;;63;60;101;115;65;84
08.07.2023 09:00;;208;75;45;83;64;78;138;158;52;;177;143;147;208;120;147
08.07.2023 10:00;;277;98;54;82;84;121;234;226;52;;248;173;225;277;152;166
08.07.2023 11:00;;275;71;50;97;75;155;239;211;71;;279;187;216;275;121;172
08.07.2023 12:00;;357;117;39;91;74;136;237;246;66;;266;206;212;357;156;165
08.07.2023 13:00;;308;123;38;99;93;102;263;234;55;;251;190;215;308;161;192
08.07.2023 14:00;;347;98;58;74;81;127;215;264;59;;247;198;213;347;156;155
08.07.2023 15:00;;335;109;60;93;83;100;210;188;54;;276;173;191;335;169;176
08.07.2023 16:00;;289;90;64;101;67;99;205;196;56;;303;183;192;289;154;168
08.07.2023 17:00;;295;103;57;102;89;76;216;232;70;;263;106;210;295;160;191
08.07.2023 18:00;;348;109;57;121;80;76;222;212;68;;268;166;188;348;166;201
08.07.2023 19:00;;268;56;53;93;63;47;141;148;54;;164;115;143;268;109;156
08.07.2023 20:00;;234;52;38;105;78;35;118;150;29;;169;75;143;234;90;183
08.07.2023 21:00;;154;59;39;77;46;44;101;127;39;;155;70;134;154;98;123
08.07.2023 22:00;;122;27;14;110;44;22;82;160;44;;140;56;136;122;41;154
08.07.2023 23:00;;144;16;11;45;22;12;27;80;22;;72;11;73;144;27;67
09.07.2023 00:00;;131;4;4;38;52;7;13;75;8;;43;4;82;131;8;90
09.07.2023 01:00;;79;9;3;21;24;8;7;37;8;;12;7;33;79;12;45
09.07.2023 02:00;;40;7;0;11;24;1;6;23;4;;14;5;22;40;7;35
09.07.2023 03:00;;26;9;2;4;20;1;2;13;1;;7;3;13;26;11;24
09.07.2023 04:00;;13;3;0;7;8;1;5;4;2;;9;1;5;13;3;15
09.07.2023 05:00;;18;3;9;5;7;3;5;14;2;;6;6;12;18;12;12
09.07.2023 06:00;;10;12;10;16;13;15;11;25;9;;19;14;20;10;22;29
09.07.2023 07:00;;37;28;17;33;37;23;46;68;16;;51;44;50;37;45;70
09.07.2023 08:00;;84;60;26;45;54;39;98;112;16;;104;92;115;84;86;99
09.07.2023 09:00;;141;106;42;88;83;84;219;212;49;;171;162;214;141;148;171
09.07.2023 10:00;;191;119;70;103;129;150;257;265;50;;268;214;237;191;189;232
09.07.2023 11:00;;188;119;44;97;105;128;264;258;56;;267;251;233;188;163;202
09.07.2023 12:00;;188;114;60;108;95;135;229;239;47;;266;197;184;188;174;203
09.07.2023 13:00;;221;99;44;95;89;123;213;205;56;;266;151;199;221;143;184
09.07.2023 14:00;;203;82;37;98;68;92;201;195;39;;211;173;199;203;119;166
09.07.2023 15:00;;200;94;48;62;66;86;177;162;39;;200;133;161;200;142;128
09.07.2023 16:00;;240;53;26;72;73;56;134;118;33;;141;98;117;240;79;145
09.07.2023 17:00;;122;18;21;29;32;22;24;58;10;;58;25;49;122;39;61
09.07.2023 18:00;;113;12;17;8;16;13;21;32;13;;27;21;29;113;29;24
09.07.2023 19:00;;123;25;19;28;25;28;67;61;18;;63;53;74;123;44;53
09.07.2023 20:00;;109;36;23;35;19;34;60;74;14;;108;58;90;109;59;54
09.07.2023 21:00;;93;24;13;30;26;35;47;70;29;;105;26;70;93;37;56
09.07.2023 22:00;;64;7;6;13;6;6;6;22;6;;33;8;28;64;13;19
09.07.2023 23:00;;29;8;0;9;11;2;4;11;3;;8;6;5;29;8;20
10.07.2023 00:00;;26;5;1;6;2;0;1;1;3;;2;0;2;26;6;8
10.07.2023 01:00;;9;2;3;0;1;1;1;3;0;;1;0;1;9;5;1
10.07.2023 02:00;;3;2;0;3;0;0;1;1;0;;1;1;0;3;2;3
10.07.2023 03:00;;3;2;0;2;0;0;0;0;1;;1;0;0;3;2;2
10.07.2023 04:00;;17;2;4;5;1;1;3;4;0;;6;2;3;17;6;6
10.07.2023 05:00;;55;16;16;34;15;8;7;17;4;;25;6;9;55;32;49
10.07.2023 06:00;;146;48;47;115;54;32;56;78;11;;96;44;70;146;95;169
10.07.2023 07:00;;305;96;53;179;137;68;148;152;33;;213;75;133;305;149;316
10.07.2023 08:00;;375;67;35;217;192;54;141;233;49;;391;74;192;375;102;409
10.07.2023 09:00;;249;42;25;75;92;37;109;113;40;;179;61;111;249;67;167
10.07.2023 10:00;;231;38;35;62;59;54;106;96;49;;118;83;98;231;73;121
10.07.2023 11:00;;274;66;33;74;49;61;126;120;47;;154;88;115;274;99;123
10.07.2023 12:00;;272;40;39;74;60;78;144;137;44;;138;96;122;272;79;134
10.07.2023 13:00;;331;70;26;73;68;89;147;156;35;;174;95;149;331;96;141
10.07.2023 14:00;;362;55;39;99;96;86;141;175;48;;198;104;165;362;94;195
10.07.2023 15:00;;454;94;52;165;106;83;182;230;80;;271;147;169;454;146;271
10.07.2023 16:00;;601;136;78;221;172;126;226;272;82;;350;172;270;601;214;393
10.07.2023 17:00;;623;137;89;250;215;105;275;351;119;;445;173;335;623;226;465
10.07.2023 18:00;;585;150;52;175;150;83;248;312;111;;382;173;381;585;202;325
10.07.2023 19:00;;431;112;45;150;129;56;156;309;90;;239;134;355;431;157;279
10.07.2023 20:00;;284;68;41;98;82;58;120;194;59;;180;103;221;284;109;180
10.07.2023 21:00;;200;50;32;54;84;32;68;137;27;;162;68;159;200;82;138
10.07.2023 22:00;;162;32;18;48;22;13;34;65;21;;65;15;66;162;50;70
10.07.2023 23:00;;82;11;8;14;13;1;8;8;3;;26;0;21;82;19;27
11.07.2023 00:00;;25;7;3;5;0;0;1;3;2;;7;4;3;25;10;5
11.07.2023 01:00;;11;1;0;2;1;0;0;1;0;;0;0;2;11;1;3
11.07.2023 02:00;;3;3;0;0;1;1;0;1;0;;2;0;0;3;3;1
11.07.2023 03:00;;7;0;2;5;0;0;1;2;0;;1;1;2;7;2;5
11.07.2023 04:00;;12;4;3;8;3;1;7;5;2;;5;5;6;12;7;11
11.07.2023 05:00;;48;23;20;31;11;9;12;21;9;;19;11;14;48;43;42
11.07.2023 06:00;;183;81;51;109;61;33;67;73;11;;107;41;60;183;132;170
11.07.2023 07:00;;354;106;73;203;171;108;141;204;50;;287;65;191;354;179;374
11.07.2023 08:00;;417;93;60;233;250;71;222;284;68;;466;126;236;417;153;483
11.07.2023 09:00;;329;85;54;113;110;79;149;183;44;;255;98;164;329;139;223
11.07.2023 10:00;;255;70;44;76;71;79;160;139;43;;195;106;155;255;114;147
11.07.2023 11:00;;272;76;31;95;51;96;162;186;42;;174;117;171;272;107;146
11.07.2023 12:00;;296;59;24;82;74;59;157;122;44;;205;100;116;296;83;156
11.07.2023 13:00;;320;68;19;96;61;84;150;148;31;;212;103;150;320;87;157
11.07.2023 14:00;;361;81;33;104;62;77;135;148;46;;213;110;139;361;114;166
11.07.2023 15:00;;452;96;57;140;103;79;141;179;64;;240;110;141;452;153;243
11.07.2023 16:00;;580;145;79;204;120;100;184;241;77;;334;113;218;580;224;324
11.07.2023 17:00;;651;173;85;251;186;103;236;290;109;;422;186;273;651;258;437
11.07.2023 18:00;;596;148;58;208;143;74;231;293;87;;377;148;309;596;206;351
11.07.2023 19:00;;393;83;52;147;111;67;140;199;49;;220;110;220;393;135;258
11.07.2023 20:00;;267;62;37;99;54;16;107;139;60;;147;67;137;267;99;153
11.07.2023 21:00;;235;51;22;91;61;21;102;117;38;;137;89;134;235;73;152
11.07.2023 22:00;;151;27;19;64;27;15;55;78;24;;77;27;68;151;46;91
11.07.2023 23:00;;74;13;5;18;16;3;11;19;6;;38;11;14;74;18;34
12.07.2023 00:00;;22;7;1;3;4;2;6;4;6;;12;3;9;22;8;7
12.07.2023 01:00;;16;3;3;0;1;1;0;5;1;;3;2;6;16;6;1
12.07.2023 02:00;;3;3;0;3;3;2;1;3;0;;3;0;3;3;3;6
12.07.2023 03:00;;9;2;0;6;0;0;1;1;0;;2;1;0;9;2;6
12.07.2023 04:00;;12;3;3;6;1;1;4;5;0;;2;2;3;12;6;7
12.07.2023 05:00;;45;20;11;22;13;6;4;11;6;;20;5;10;45;31;35
12.07.2023 06:00;;138;36;34;85;43;32;36;46;13;;59;28;46;138;70;128
12.07.2023 07:00;;302;97;60;168;143;63;122;144;39;;258;80;122;302;157;311
12.07.2023 08:00;;418;67;51;222;239;63;166;256;56;;441;101;215;418;118;461
12.07.2023 09:00;;245;62;16;108;93;44;116;114;29;;228;76;109;245;78;201
12.07.2023 10:00;;230;47;32;50;65;73;126;103;31;;165;109;106;230;79;115
12.07.2023 11:00;;278;41;36;54;56;59;163;149;59;;167;139;136;278;77;110
12.07.2023 12:00;;358;58;35;89;70;77;165;148;53;;195;139;154;358;93;159
12.07.2023 13:00;;347;58;30;108;76;53;151;149;40;;191;112;120;347;88;184
12.07.2023 14:00;;370;70;56;127;91;97;153;204;45;;219;129;174;370;126;218
12.07.2023 15:00;;468;103;55;154;116;106;221;250;72;;315;157;201;468;158;270
12.07.2023 16:00;;581;123;65;225;153;103;232;293;56;;387;177;260;581;188;378
12.07.2023 17:00;;683;130;72;267;204;138;336;357;118;;513;192;345;683;202;471
12.07.2023 18:00;;613;140;71;209;207;83;247;415;117;;432;153;390;613;211;416
12.07.2023 19:00;;467;88;57;204;128;67;219;282;51;;311;125;295;467;145;332
12.07.2023 20:00;;347;83;48;124;103;39;132;262;63;;223;91;244;347;131;227
12.07.2023 21:00;;255;54;26;111;55;41;111;145;41;;176;77;149;255;80;166
12.07.2023 22:00;;221;36;7;65;56;18;61;82;33;;104;26;90;221;43;121
12.07.2023 23:00;;90;16;4;21;9;3;16;21;4;;30;8;22;90;20;30
13.07.2023 00:00;;39;3;3;8;6;0;2;10;1;;6;2;13;39;6;14
13.07.2023 01:00;;19;3;2;3;1;1;1;7;1;;1;0;1;19;5;4
13.07.2023 02:00;;11;3;3;2;1;0;2;1;2;;4;0;1;11;6;3
13.07.2023 03:00;;5;2;1;3;3;0;0;2;2;;0;0;1;5;3;6
13.07.2023 04:00;;13;4;3;4;4;1;2;5;1;;8;0;4;13;7;8
13.07.2023 05:00;;44;17;13;24;13;6;14;17;4;;22;12;10;44;30;37
13.07.2023 06:00;;172;61;66;91;58;26;50;75;18;;94;31;72;172;127;149
13.07.2023 07:00;;339;102;68;163;160;66;151;174;52;;265;84;157;339;170;323
13.07.2023 08:00;;404;84;57;253;222;77;237;269;69;;473;129;158;404;141;475
13.07.2023 09:00;;281;47;30;94;114;82;135;121;35;;210;89;92;281;77;208
13.07.2023 10:00;;252;53;36;72;60;75;174;164;45;;196;134;129;252;89;132
13.07.2023 11:00;;272;69;35;89;76;98;174;196;60;;216;132;165;272;104;165
13.07.2023 12:00;;347;62;33;82;74;84;193;188;36;;254;146;168;347;95;156
13.07.2023 13:00;;391;71;38;101;78;85;191;211;47;;248;139;165;391;109;179
13.07.2023 14:00;;412;55;34;122;79;77;176;168;53;;214;149;162;412;89;201
13.07.2023 15:00;;465;105;40;178;122;96;223;223;65;;288;160;196;465;145;300
13.07.2023 16:00;;627;150;59;235;181;91;233;282;71;;338;156;251;627;209;416
13.07.2023 17:00;;670;135;74;267;207;107;262;372;97;;467;176;363;670;209;474
13.07.2023 18:00;;597;126;68;222;188;122;254;374;118;;386;168;328;597;194;410
13.07.2023 19:00;;443;65;42;157;104;80;142;193;64;;256;109;179;443;107;261
13.07.2023 20:00;;278;61;25;116;91;30;107;188;54;;178;80;180;278;86;207
13.07.2023 21:00;;255;28;29;87;59;32;63;122;35;;131;53;117;255;57;146
13.07.2023 22:00;;193;23;10;90;23;12;45;91;35;;82;22;82;193;33;113
13.07.2023 23:00;;109;11;6;28;12;3;6;29;9;;29;6;22;109;17;40
14.07.2023 00:00;;27;5;2;7;1;1;1;8;9;;10;1;10;27;7;8
14.07.2023 01:00;;21;4;1;4;0;0;0;0;0;;6;0;3;21;5;4
14.07.2023 02:00;;11;6;0;2;0;1;2;2;0;;2;0;1;11;6;2
14.07.2023 03:00;;7;5;5;4;1;0;0;1;1;;1;0;1;7;10;5
14.07.2023 04:00;;16;3;2;4;3;0;1;5;1;;3;1;4;16;5;7
14.07.2023 05:00;;42;11;18;17;6;4;10;10;3;;21;5;11;42;29;23
14.07.2023 06:00;;143;52;44;83;51;16;65;55;14;;75;43;48;143;96;134
14.07.2023 07:00;;252;76;38;118;101;42;119;122;43;;180;66;111;252;114;219
14.07.2023 08:00;;301;52;41;129;132;62;143;172;44;;268;80;128;301;93;261
14.07.2023 09:00;;265;62;38;93;79;69;112;137;60;;174;86;148;265;100;172
14.07.2023 10:00;;250;70;30;85;61;84;174;149;50;;189;102;155;250;100;146
14.07.2023 11:00;;286;47;26;90;65;97;179;149;58;;194;143;160;286;73;155
14.07.2023 12:00;;374;106;34;147;80;86;174;186;58;;224;137;194;374;140;227
14.07.2023 13:00;;421;68;53;129;117;118;176;218;49;;265;167;195;421;121;246
14.07.2023 14:00;;424;93;62;134;116;99;217;223;60;;302;153;195;424;155;250
14.07.2023 15:00;;478;126;51;199;131;98;248;233;69;;309;211;221;478;177;330
14.07.2023 16:00;;465;132;48;172;140;127;255;270;71;;338;193;234;465;180;312
14.07.2023 17:00;;494;96;56;183;186;120;233;328;86;;369;181;302;494;152;369
14.07.2023 18:00;;443;113;65;193;283;109;287;316;86;;464;168;292;443;178;476
14.07.2023 19:00;;468;70;35;147;187;83;190;268;76;;311;126;253;468;105;334
14.07.2023 20:00;;280;59;35;129;117;33;138;224;63;;235;99;193;280;94;246
14.07.2023 21:00;;170;49;34;152;177;52;147;218;56;;322;89;212;170;83;329
14.07.2023 22:00;;284;52;14;143;159;41;152;172;64;;435;75;162;284;66;302
14.07.2023 23:00;;147;27;8;69;46;12;48;80;25;;119;20;61;147;35;115
15.07.2023 00:00;;127;10;4;48;28;9;11;55;19;;70;6;54;127;14;76
15.07.2023 01:00;;72;11;7;25;14;4;9;55;13;;24;3;34;72;18;39
15.07.2023 02:00;;58;5;3;23;13;3;3;20;1;;11;3;19;58;8;36
15.07.2023 03:00;;19;6;0;7;8;0;0;9;0;;13;2;6;19;6;15
15.07.2023 04:00;;14;2;0;15;4;0;2;11;1;;4;1;5;14;2;19
15.07.2023 05:00;;18;4;4;1;6;2;6;15;1;;4;3;8;18;8;7
15.07.2023 06:00;;26;5;8;17;16;4;13;25;2;;22;16;21;26;13;33
15.07.2023 07:00;;51;19;7;35;34;10;28;37;11;;53;25;31;51;26;69
15.07.2023 08:00;;123;25;14;49;55;31;75;88;24;;139;40;87;123;39;104
15.07.2023 09:00;;136;43;20;60;47;44;94;110;28;;164;84;79;136;63;107
15.07.2023 10:00;;100;17;13;45;53;29;80;52;12;;124;64;42;100;30;98
15.07.2023 11:00;;110;24;10;39;34;56;63;55;19;;106;63;51;110;34;73
15.07.2023 12:00;;194;21;12;51;44;41;88;73;19;;175;73;74;194;33;95
15.07.2023 13:00;;195;20;12;52;60;54;91;94;29;;157;74;92;195;32;112
15.07.2023 14:00;;201;29;21;57;49;83;111;113;19;;154;85;88;201;50;106
15.07.2023 15:00;;187;34;32;47;40;57;95;127;26;;164;66;104;187;66;87
15.07.2023 16:00;;253;39;18;71;91;65;148;172;48;;215;114;150;253;57;162
15.07.2023 17:00;;232;44;21;69;66;44;105;113;27;;181;105;115;232;65;135
15.07.2023 18:00;;238;38;26;83;64;67;136;142;34;;175;89;118;238;64;147
15.07.2023 19:00;;224;41;14;78;76;20;100;147;40;;158;78;130;224;55;154
15.07.2023 20:00;;136;41;7;89;58;22;74;131;33;;126;53;126;136;48;147
15.07.2023 21:00;;119;37;13;73;46;21;78;112;23;;102;49;105;119;50;119
15.07.2023 22:00;;103;11;7;103;54;14;47;107;16;;152;31;74;103;18;157
15.07.2023 23:00;;104;13;6;42;14;5;29;38;15;;55;30;31;104;19;56
16.07.2023 00:00;;72;6;4;23;8;4;6;12;4;;23;8;17;72;10;31
16.07.2023 01:00;;61;2;0;9;4;1;4;6;9;;10;4;9;61;2;13
16.07.2023 02:00;;27;0;4;2;1;0;1;4;2;;11;2;5;27;4;3
16.07.2023 03:00;;19;1;2;1;3;0;3;3;2;;2;0;1;19;3;4
16.07.2023 04:00;;12;1;1;8;7;1;1;6;0;;6;1;7;12;2;15
16.07.2023 05:00;;16;6;2;2;8;2;6;10;1;;8;2;9;16;8;10
16.07.2023 06:00;;27;8;6;17;7;6;8;11;2;;16;7;4;27;14;24
16.07.2023 07:00;;29;14;10;17;26;19;25;32;5;;43;14;35;29;24;43
16.07.2023 08:00;;61;30;12;39;39;20;62;60;6;;79;70;51;61;42;78
16.07.2023 09:00;;100;52;33;96;63;89;127;179;30;;138;127;138;100;85;159
16.07.2023 10:00;;166;115;60;102;109;120;251;245;65;;272;227;240;166;175;211
16.07.2023 11:00;;208;155;81;170;119;201;372;332;66;;405;287;332;208;236;289
16.07.2023 12:00;;278;150;76;198;130;229;433;438;71;;424;329;401;278;226;328
16.07.2023 13:00;;275;150;93;237;173;216;464;502;107;;443;433;448;275;243;410
16.07.2023 14:00;;343;178;94;259;191;211;435;508;87;;449;326;428;343;272;450
16.07.2023 15:00;;294;135;93;254;135;243;374;534;114;;459;331;493;294;228;389
16.07.2023 16:00;;282;127;75;229;142;173;357;512;99;;425;257;400;282;202;371
16.07.2023 17:00;;290;121;84;188;150;145;302;383;96;;374;259;340;290;205;338
16.07.2023 18:00;;334;102;48;178;106;101;237;331;99;;248;228;307;334;150;284
16.07.2023 19:00;;265;53;42;125;109;83;194;214;67;;239;143;213;265;95;234
16.07.2023 20:00;;192;41;32;75;79;43;114;175;51;;141;120;152;192;73;154
16.07.2023 21:00;;154;37;18;47;55;25;79;133;26;;96;65;114;154;55;102
16.07.2023 22:00;;78;15;6;30;23;20;28;38;15;;52;23;35;78;21;53
16.07.2023 23:00;;57;12;4;12;8;5;11;12;6;;8;7;14;57;16;20
17.07.2023 00:00;;22;0;1;4;4;0;4;2;2;;4;5;2;22;1;8
17.07.2023 01:00;;6;0;0;0;0;0;1;1;1;;1;0;0;6;0;0
17.07.2023 02:00;;2;1;0;1;1;0;2;0;0;;1;1;0;2;1;2
17.07.2023 03:00;;2;2;0;5;0;0;0;3;0;;0;0;0;2;2;5
17.07.2023 04:00;;10;3;3;5;5;0;1;3;1;;2;2;2;10;6;10
17.07.2023 05:00;;51;16;15;21;13;10;11;16;8;;29;9;17;51;31;34
17.07.2023 06:00;;144;59;55;103;58;42;53;84;19;;87;51;65;144;114;161
17.07.2023 07:00;;296;79;70;167;151;48;133;158;51;;210;90;132;296;149;318
17.07.2023 08:00;;302;59;40;189;163;69;175;198;51;;349;106;156;302;99;352
17.07.2023 09:00;;232;43;17;117;90;44;131;132;34;;227;85;127;232;60;207
17.07.2023 10:00;;231;31;36;69;52;76;113;112;36;;123;84;104;231;67;121
17.07.2023 11:00;;270;51;30;82;62;98;185;189;55;;216;151;165;270;81;144
17.07.2023 12:00;;287;44;36;78;58;85;179;120;34;;228;140;134;287;80;136
17.07.2023 13:00;;317;51;24;101;59;85;178;161;46;;241;138;144;317;75;160
17.07.2023 14:00;;378;59;33;111;94;110;182;198;48;;286;149;165;378;92;205
17.07.2023 15:00;;393;104;56;147;128;121;210;229;67;;306;159;214;393;160;275
17.07.2023 16:00;;591;128;57;258;172;110;236;303;100;;326;183;266;591;185;430
17.07.2023 17:00;;671;117;55;230;193;100;291;370;110;;483;195;334;671;172;423
17.07.2023 18:00;;594;114;45;204;135;71;238;299;106;;318;189;354;594;159;339
17.07.2023 19:00;;382;69;27;112;96;43;152;206;87;;186;104;281;382;96;208
17.07.2023 20:00;;253;65;18;64;64;41;81;144;41;;123;57;143;253;83;128
17.07.2023 21:00;;186;33;22;43;34;20;47;62;39;;71;40;79;186;55;77
17.07.2023 22:00;;123;15;11;51;17;5;24;44;9;;38;13;38;123;26;68
17.07.2023 23:00;;59;10;5;23;6;0;5;14;9;;21;3;9;59;15;29
18.07.2023 00:00;;13;3;4;3;1;1;1;2;7;;3;0;3;13;7;4
18.07.2023 01:00;;17;0;1;0;1;0;0;1;2;;0;0;1;17;1;1
18.07.2023 02:00;;1;2;1;1;0;1;1;0;0;;0;1;0;1;3;1
18.07.2023 03:00;;5;2;0;4;0;0;0;2;0;;0;0;0;5;2;4
18.07.2023 04:00;;7;3;2;4;4;2;2;3;0;;3;2;3;7;5;8
18.07.2023 05:00;;42;31;20;33;18;8;8;19;10;;26;6;19;42;51;51
18.07.2023 06:00;;134;48;59;86;65;40;55;74;17;;89;44;56;134;107;151
18.07.2023 07:00;;285;93;76;200;173;70;170;187;49;;272;75;166;285;169;373
18.07.2023 08:00;;371;78;38;259;214;69;230;218;51;;472;106;194;371;116;473
18.07.2023 09:00;;250;60;43;110;109;63;146;142;35;;222;99;116;250;103;219
18.07.2023 10:00;;234;52;48;103;75;90;169;138;47;;255;115;127;234;100;178
18.07.2023 11:00;;254;73;47;88;50;89;223;173;40;;217;169;190;254;120;138
18.07.2023 12:00;;316;78;47;101;83;108;215;182;43;;229;176;183;316;125;184
18.07.2023 13:00;;346;74;23;112;91;112;194;229;58;;260;142;175;346;97;203
18.07.2023 14:00;;385;91;34;138;101;105;222;257;54;;243;193;204;385;125;239
18.07.2023 15:00;;410;117;54;210;118;116;232;264;65;;316;188;234;410;171;328
18.07.2023 16:00;;562;159;88;264;172;108;289;370;121;;397;228;307;562;247;436
18.07.2023 17:00;;688;144;103;307;228;118;328;376;104;;559;238;365;688;247;535
18.07.2023 18:00;;608;159;65;253;177;117;291;386;101;;458;269;368;608;224;430
18.07.2023 19:00;;471;104;51;187;144;80;200;338;104;;294;147;341;471;155;331
18.07.2023 20:00;;336;67;33;177;89;63;164;259;46;;204;126;215;336;100;266
18.07.2023 21:00;;236;54;32;113;83;38;127;193;52;;162;125;188;236;86;196
18.07.2023 22:00;;180;28;14;89;33;17;70;67;27;;148;33;75;180;42;122
18.07.2023 23:00;;75;8;3;19;18;0;15;20;15;;42;9;29;75;11;37
19.07.2023 00:00;;42;3;3;5;4;5;5;8;1;;14;2;8;42;6;9
19.07.2023 01:00;;19;2;0;5;6;1;1;5;0;;0;1;0;19;2;11
19.07.2023 02:00;;12;0;1;2;0;2;1;1;0;;3;1;1;12;1;2
19.07.2023 03:00;;9;4;1;4;1;0;0;3;0;;0;0;6;9;5;5
19.07.2023 04:00;;12;6;3;5;4;0;2;7;0;;5;2;4;12;9;9
19.07.2023 05:00;;47;27;21;30;13;3;6;15;4;;17;7;14;47;48;43
19.07.2023 06:00;;159;56;62;105;72;39;67;77;16;;87;56;69;159;118;177
19.07.2023 07:00;;331;102;73;175;159;63;160;177;60;;269;93;157;331;175;334
19.07.2023 08:00;;320;73;43;248;214;82;215;231;59;;436;114;193;320;116;462
19.07.2023 09:00;;218;52;35;106;80;36;134;133;33;;220;91;128;218;87;186
19.07.2023 10:00;;249;29;22;50;58;98;155;120;38;;197;105;115;249;51;108
19.07.2023 11:00;;220;64;35;53;73;71;163;176;59;;192;130;147;220;99;126
19.07.2023 12:00;;256;55;31;91;62;74;157;160;43;;201;167;127;256;86;153
19.07.2023 13:00;;334;59;25;115;71;79;151;169;34;;223;126;165;334;84;186
19.07.2023 14:00;;372;65;42;104;108;107;182;187;52;;209;147;194;372;107;212
19.07.2023 15:00;;412;104;49;196;113;109;250;212;67;;298;193;185;412;153;309
19.07.2023 16:00;;558;136;58;220;145;111;264;327;83;;329;208;261;558;194;365
19.07.2023 17:00;;619;133;69;292;190;117;294;363;101;;500;221;315;619;202;482
19.07.2023 18:00;;597;110;64;207;170;124;230;294;94;;410;154;319;597;174;377
19.07.2023 19:00;;401;69;39;147;100;60;190;238;70;;228;135;214;401;108;247
19.07.2023 20:00;;278;63;29;113;70;35;112;163;69;;176;97;159;278;92;183
19.07.2023 21:00;;210;29;20;102;53;16;85;104;46;;153;80;98;210;49;155
19.07.2023 22:00;;177;19;11;80;15;13;38;66;13;;87;17;54;177;30;95
19.07.2023 23:00;;88;10;3;29;9;7;15;20;14;;31;12;17;88;13;38
20.07.2023 00:00;;39;3;4;5;1;0;0;8;1;;7;0;3;39;7;6
20.07.2023 01:00;;20;2;0;7;3;0;2;4;1;;2;1;1;20;2;10
20.07.2023 02:00;;6;0;0;0;3;0;0;4;0;;3;0;0;6;0;3
20.07.2023 03:00;;7;2;1;4;1;0;0;2;1;;1;0;0;7;3;5
20.07.2023 04:00;;11;2;1;9;1;0;2;4;1;;3;4;4;11;3;10
20.07.2023 05:00;;41;20;14;23;16;9;6;11;3;;19;4;9;41;34;39
20.07.2023 06:00;;137;37;60;84;51;32;57;78;18;;82;40;61;137;97;135
20.07.2023 07:00;;266;83;65;151;137;64;140;146;40;;225;72;123;266;148;288
20.07.2023 08:00;;331;53;39;196;191;57;189;191;45;;397;104;160;331;92;387
20.07.2023 09:00;;256;41;24;123;111;45;112;132;41;;207;76;110;256;65;234
20.07.2023 10:00;;225;34;39;84;49;77;108;123;30;;165;98;124;225;73;133
20.07.2023 11:00;;264;71;38;86;60;80;164;155;41;;164;122;147;264;109;146
20.07.2023 12:00;;272;69;27;74;68;62;129;144;32;;180;136;153;272;96;142
20.07.2023 13:00;;337;59;29;77;83;84;179;181;53;;227;133;169;337;88;160
20.07.2023 14:00;;337;53;51;135;80;77;175;182;41;;237;164;194;337;104;215
20.07.2023 15:00;;477;109;41;178;107;82;221;242;80;;258;185;211;477;150;285
20.07.2023 16:00;;565;122;87;242;169;110;257;309;81;;386;191;288;565;209;411
20.07.2023 17:00;;602;166;75;222;205;133;260;368;108;;449;196;329;602;241;427
20.07.2023 18:00;;583;116;63;219;170;103;278;369;65;;415;196;341;583;179;389
20.07.2023 19:00;;429;81;34;187;120;82;174;263;59;;272;133;242;429;115;307
20.07.2023 20:00;;256;83;33;146;80;63;115;202;44;;195;95;178;256;116;226
20.07.2023 21:00;;203;36;21;113;58;21;82;115;35;;152;64;128;203;57;171
20.07.2023 22:00;;147;30;7;136;46;8;47;87;34;;134;37;93;147;37;182
20.07.2023 23:00;;92;11;11;20;10;4;11;16;5;;30;3;18;92;22;30
21.07.2023 00:00;;35;4;3;11;4;1;5;4;1;;6;1;2;35;7;15
21.07.2023 01:00;;16;1;4;5;2;0;2;3;0;;4;0;3;16;5;7
21.07.2023 02:00;;5;0;2;1;3;1;0;4;2;;0;1;2;5;2;4
21.07.2023 03:00;;4;1;0;3;2;1;0;5;1;;0;2;1;4;1;5
21.07.2023 04:00;;9;3;5;5;4;0;2;1;0;;6;2;2;9;8;9
21.07.2023 05:00;;33;14;9;12;11;3;10;11;3;;10;5;9;33;23;23
21.07.2023 06:00;;89;32;23;51;32;18;32;38;8;;46;27;42;89;55;83
21.07.2023 07:00;;216;48;34;89;72;28;82;87;22;;130;52;81;216;82;161
21.07.2023 08:00;;238;44;18;104;103;28;107;124;40;;206;67;97;238;62;207
21.07.2023 09:00;;177;29;21;78;76;31;85;86;27;;119;67;71;177;50;154
21.07.2023 10:00;164;180;40;19;52;41;56;89;114;35;;139;78;96;344;59;93
21.07.2023 11:00;160;217;70;23;85;54;83;132;138;39;;182;108;144;377;93;139
21.07.2023 12:00;155;306;69;35;86;55;98;140;130;56;;168;137;131;461;104;141
21.07.2023 13:00;161;266;65;34;76;50;78;105;111;36;;124;84;77;427;99;126
21.07.2023 14:00;132;248;41;29;55;34;61;59;77;26;;128;49;76;380;70;89
21.07.2023 15:00;206;325;66;27;126;86;93;136;139;38;;188;98;127;531;93;212
21.07.2023 16:00;179;298;49;37;104;57;56;112;123;29;;201;117;115;477;86;161
21.07.2023 17:00;202;312;54;42;136;84;55;131;138;31;;243;97;128;514;96;220
21.07.2023 18:00;209;323;39;33;122;97;44;133;161;40;;247;107;131;532;72;219
21.07.2023 19:00;191;246;52;18;123;78;22;82;104;42;;174;65;101;437;70;201
21.07.2023 20:00;102;171;47;11;86;70;21;68;90;35;;130;43;82;273;58;156
21.07.2023 21:00;91;130;21;10;63;25;10;37;62;14;;89;37;56;221;31;88
21.07.2023 22:00;68;134;18;9;101;45;7;27;56;20;;108;19;58;202;27;146
21.07.2023 23:00;49;117;14;3;73;27;6;11;59;16;;105;7;29;166;17;100
22.07.2023 00:00;33;73;5;6;22;21;0;7;15;4;;48;3;17;106;11;43
22.07.2023 01:00;14;34;4;4;10;3;1;4;11;1;;10;1;6;48;8;13
22.07.2023 02:00;19;11;3;4;1;2;3;1;6;0;;1;1;1;30;7;3
22.07.2023 03:00;3;13;7;0;2;0;0;0;0;0;;1;0;0;16;7;2
22.07.2023 04:00;2;3;0;2;5;1;0;4;2;0;;2;0;1;5;2;6
22.07.2023 05:00;4;22;3;4;2;2;1;6;7;2;;13;2;4;26;7;4
22.07.2023 06:00;19;18;4;6;11;7;1;13;13;2;;19;8;5;37;10;18
22.07.2023 07:00;21;41;9;6;27;11;12;14;28;7;;30;17;27;62;15;38
22.07.2023 08:00;68;93;23;15;35;21;23;49;46;30;;49;53;41;161;38;56
22.07.2023 09:00;114;153;48;34;41;42;54;79;101;32;;108;59;90;267;82;83
22.07.2023 10:00;209;231;71;44;74;67;98;162;193;56;;206;147;211;440;115;141
22.07.2023 11:00;216;268;95;78;87;70;127;246;240;62;;267;223;244;484;173;157
22.07.2023 12:00;230;260;110;61;114;83;168;315;220;79;;327;243;204;490;171;197
22.07.2023 13:00;255;355;97;72;134;72;181;310;295;63;;373;256;283;610;169;206
22.07.2023 14:00;184;396;98;64;132;115;175;355;357;75;;342;334;309;580;162;247
22.07.2023 15:00;194;354;103;78;175;156;176;430;482;78;;428;356;406;548;181;331
22.07.2023 16:00;213;358;111;75;185;167;199;347;396;79;;489;339;340;571;186;352
22.07.2023 17:00;243;390;99;53;256;181;152;389;412;83;;487;314;378;633;152;437
22.07.2023 18:00;207;346;87;59;211;178;125;275;340;92;;430;188;260;553;146;389
22.07.2023 19:00;194;345;67;24;209;168;58;219;308;68;;343;176;278;539;91;377
22.07.2023 20:00;148;230;45;42;170;120;40;150;203;51;;260;98;187;378;87;290
22.07.2023 21:00;105;139;35;10;145;75;49;90;165;45;;205;53;144;244;45;220
22.07.2023 22:00;110;116;16;10;152;73;11;78;95;24;;153;46;66;226;26;225
22.07.2023 23:00;78;110;19;7;96;48;10;46;82;17;;168;22;50;188;26;144
23.07.2023 00:00;41;71;16;4;65;45;13;18;62;16;;119;12;32;112;20;110
23.07.2023 01:00;25;55;6;5;10;14;4;10;22;5;;26;9;25;80;11;24
23.07.2023 02:00;19;34;3;1;6;2;5;5;3;5;;11;4;6;53;4;8
23.07.2023 03:00;6;10;3;1;1;5;0;0;6;0;;2;2;2;16;4;6
23.07.2023 04:00;6;11;2;0;3;0;0;3;3;0;;1;0;3;17;2;3
23.07.2023 05:00;12;14;5;6;5;2;1;3;3;1;;3;3;5;26;11;7
23.07.2023 06:00;10;9;5;2;14;8;3;11;13;1;;14;6;10;19;7;22
23.07.2023 07:00;18;16;15;8;6;14;4;12;19;3;;22;13;16;34;23;20
23.07.2023 08:00;26;54;18;13;28;16;14;49;46;10;;41;36;37;80;31;44
23.07.2023 09:00;27;55;20;18;40;25;20;52;49;17;;61;55;36;82;38;65
23.07.2023 10:00;34;75;18;20;19;19;31;50;44;11;;60;52;34;109;38;38
23.07.2023 11:00;35;55;22;11;16;16;51;41;26;4;;58;41;30;90;33;32
23.07.2023 12:00;59;55;24;3;19;18;43;45;34;8;;45;53;45;114;27;37
23.07.2023 13:00;69;90;33;23;34;23;58;68;69;15;;115;82;53;159;56;57
23.07.2023 14:00;101;163;38;24;69;70;74;159;123;24;;195;110;109;264;62;139
23.07.2023 15:00;106;143;53;27;83;78;78;155;146;39;;224;143;113;249;80;161
23.07.2023 16:00;120;138;68;27;109;102;62;199;205;47;;215;126;197;258;95;211
23.07.2023 17:00;130;153;57;11;78;68;61;136;170;43;;190;132;134;283;68;146
23.07.2023 18:00;117;138;39;20;70;86;30;111;147;32;;189;79;118;255;59;156
23.07.2023 19:00;100;134;40;14;37;31;36;64;97;13;;75;49;78;234;54;68
23.07.2023 20:00;74;74;18;5;16;15;9;38;45;13;;40;29;47;148;23;31
23.07.2023 21:00;44;47;5;4;10;8;4;15;16;2;;19;13;14;91;9;18
23.07.2023 22:00;23;37;8;4;5;3;5;3;11;2;;7;4;9;60;12;8
23.07.2023 23:00;7;26;2;0;7;4;0;7;3;1;;4;0;4;33;2;11
24.07.2023 00:00;4;12;0;0;1;1;0;1;2;0;;2;2;1;16;0;2
24.07.2023 01:00;7;7;0;0;5;1;0;2;1;1;;2;2;1;14;0;6
24.07.2023 02:00;4;0;1;0;0;0;1;0;0;1;;0;0;0;4;1;0
24.07.2023 03:00;1;4;2;0;3;0;0;1;2;0;;0;0;0;5;2;3
24.07.2023 04:00;12;11;2;1;3;3;0;0;4;1;;2;1;4;23;3;6
24.07.2023 05:00;33;36;17;6;14;7;3;5;11;4;;11;2;5;69;23;21
24.07.2023 06:00;119;109;25;36;57;50;17;32;49;10;;54;27;48;228;61;107
24.07.2023 07:00;279;214;58;39;108;87;42;89;114;33;;174;46;91;493;97;195
24.07.2023 08:00;299;277;54;28;152;158;36;133;150;39;;293;65;121;576;82;310
24.07.2023 09:00;166;225;34;13;72;66;26;110;104;38;;157;66;79;391;47;138
24.07.2023 10:00;128;175;24;16;54;31;40;79;87;29;;132;69;85;303;40;85
24.07.2023 11:00;130;181;35;17;80;37;65;127;137;27;;112;87;122;311;52;117
24.07.2023 12:00;120;248;36;34;50;39;56;87;88;36;;110;80;94;368;70;89
24.07.2023 13:00;157;246;45;21;56;46;35;121;105;19;;112;103;97;403;66;102
24.07.2023 14:00;134;220;37;21;49;45;36;83;78;27;;119;93;62;354;58;94
24.07.2023 15:00;157;257;35;23;85;68;31;117;99;36;;150;90;80;414;58;153
24.07.2023 16:00;175;410;57;23;128;79;65;99;109;42;;189;86;89;585;80;207
24.07.2023 17:00;189;456;89;28;153;112;56;166;198;57;;277;118;203;645;117;265
24.07.2023 18:00;222;420;63;37;117;96;52;169;193;63;;257;117;224;642;100;213
24.07.2023 19:00;190;307;44;23;87;76;25;113;154;66;;169;89;208;497;67;163
24.07.2023 20:00;133;203;41;10;52;58;15;77;121;39;;105;67;107;336;51;110
24.07.2023 21:00;74;128;15;11;43;20;15;35;34;19;;60;18;43;202;26;63
24.07.2023 22:00;57;97;6;5;17;13;2;12;34;8;;28;5;39;154;11;30
24.07.2023 23:00;26;50;5;4;15;8;0;6;8;3;;7;2;8;76;9;23
25.07.2023 00:00;9;21;2;0;2;4;0;0;8;0;;2;0;1;30;2;6
25.07.2023 01:00;5;7;2;2;3;0;0;2;0;0;;1;0;0;12;4;3
25.07.2023 02:00;3;6;2;0;0;1;0;2;1;0;;2;1;1;9;2;1
25.07.2023 03:00;0;6;2;0;2;0;0;0;1;0;;0;0;0;6;2;2
25.07.2023 04:00;10;7;5;1;2;4;0;0;4;1;;5;2;3;17;6;6
25.07.2023 05:00;38;45;19;13;21;12;3;3;16;2;;12;2;13;83;32;33
25.07.2023 06:00;115;87;30;34;57;43;21;27;46;11;;60;17;39;202;64;100
25.07.2023 07:00;303;252;62;45;133;101;52;81;133;36;;177;33;113;555;107;234
25.07.2023 08:00;296;286;57;36;202;167;44;108;176;38;;324;46;141;582;93;369
25.07.2023 09:00;174;201;22;17;89;76;30;80;89;30;;152;50;68;375;39;165
25.07.2023 10:00;120;189;53;27;47;36;71;67;83;20;;91;60;88;309;80;83
25.07.2023 11:00;132;222;27;23;46;34;37;88;87;36;;125;63;75;354;50;80
25.07.2023 12:00;186;246;38;15;58;49;57;115;115;30;;138;108;125;432;53;107
25.07.2023 13:00;147;292;43;29;70;60;63;153;119;16;;183;100;90;439;72;130
25.07.2023 14:00;163;306;68;23;89;61;54;148;127;54;;189;118;148;469;91;150
25.07.2023 15:00;202;354;69;33;139;91;71;168;190;58;;217;125;174;556;102;230
25.07.2023 16:00;226;438;89;55;204;104;75;141;238;46;;249;113;176;664;144;308
25.07.2023 17:00;242;529;88;75;214;156;79;175;247;56;;334;124;212;771;163;370
25.07.2023 18:00;259;465;80;40;147;129;80;167;213;72;;283;129;235;724;120;276
25.07.2023 19:00;191;297;47;24;87;72;35;107;141;39;;155;80;143;488;71;159
25.07.2023 20:00;116;210;44;22;88;59;28;80;86;37;;119;63;104;326;66;147
25.07.2023 21:00;92;158;26;8;42;23;20;52;50;21;;76;32;62;250;34;65
25.07.2023 22:00;66;117;25;7;26;25;4;16;39;5;;66;10;43;183;32;51
25.07.2023 23:00;34;73;5;2;21;12;0;5;24;7;;13;5;17;107;7;33
26.07.2023 00:00;8;20;4;1;2;4;0;2;1;1;;4;0;2;28;5;6
26.07.2023 01:00;9;13;0;2;9;2;0;7;2;4;;4;6;1;22;2;11
26.07.2023 02:00;1;5;0;0;0;0;1;2;0;0;;1;0;0;6;0;0
26.07.2023 03:00;2;10;3;1;3;0;1;1;7;0;;1;0;0;12;4;3
26.07.2023 04:00;8;10;3;2;4;1;0;1;3;1;;3;2;4;18;5;5
26.07.2023 05:00;41;45;15;9;22;9;5;5;10;1;;14;1;14;86;24;31
26.07.2023 06:00;112;116;31;42;71;47;28;32;51;11;;53;15;38;228;73;118
26.07.2023 07:00;287;241;62;42;142;117;62;123;135;39;;203;60;111;528;104;259
26.07.2023 08:00;309;308;54;36;204;185;39;115;172;52;;351;57;143;617;90;389
26.07.2023 09:00;196;201;41;22;93;92;27;90;132;43;;190;71;111;397;63;185
26.07.2023 10:00;134;165;28;34;57;46;79;119;83;30;;102;72;77;299;62;103
26.07.2023 11:00;126;215;28;25;47;53;54;118;92;33;;144;87;73;341;53;100
26.07.2023 12:00;124;249;24;4;61;58;113;106;100;25;;150;68;92;373;28;119
26.07.2023 13:00;112;238;41;8;64;41;30;198;98;22;;223;139;67;350;49;105
26.07.2023 14:00;106;221;23;18;55;43;50;56;62;12;;77;58;52;327;41;98
26.07.2023 15:00;176;346;54;28;123;80;55;124;139;36;;150;74;122;522;82;203
26.07.2023 16:00;222;410;89;37;177;119;74;179;209;42;;272;121;171;632;126;296
26.07.2023 17:00;263;520;84;65;213;180;88;205;271;63;;383;137;228;783;149;393
26.07.2023 18:00;217;450;89;56;199;140;69;208;275;62;;364;136;240;667;145;339
26.07.2023 19:00;185;348;61;35;153;88;57;105;164;55;;196;91;207;533;96;241
26.07.2023 20:00;172;221;47;21;84;65;32;94;122;41;;164;72;98;393;68;149
26.07.2023 21:00;100;156;28;17;73;28;27;43;75;15;;96;36;83;256;45;101
26.07.2023 22:00;114;144;10;4;71;22;3;17;52;11;;56;4;47;258;14;93
26.07.2023 23:00;36;60;6;3;9;8;0;7;6;8;;20;9;10;96;9;17
27.07.2023 00:00;15;25;2;0;5;0;1;2;4;2;;6;2;4;40;2;5
27.07.2023 01:00;7;21;1;3;2;2;0;2;9;0;;1;4;7;28;4;4
27.07.2023 02:00;1;3;1;0;2;1;0;1;3;0;;2;0;1;4;1;3
27.07.2023 03:00;4;11;2;0;3;0;1;0;1;0;;0;1;0;15;2;3
27.07.2023 04:00;6;9;3;1;1;3;0;1;4;2;;7;1;3;15;4;4
27.07.2023 05:00;24;24;7;2;12;12;2;5;8;1;;6;4;7;48;9;24
27.07.2023 06:00;57;58;16;13;31;15;7;9;16;7;;30;13;16;115;29;46
27.07.2023 07:00;118;107;23;21;52;48;15;30;37;5;;57;20;25;225;44;100
27.07.2023 08:00;108;115;15;14;64;40;12;32;52;16;;94;18;47;223;29;104
27.07.2023 09:00;63;80;11;4;27;18;5;21;26;9;;45;14;20;143;15;45
27.07.2023 10:00;40;71;9;5;14;12;7;23;17;9;;35;18;22;111;14;26
27.07.2023 11:00;73;98;10;5;15;17;27;42;23;8;;50;27;25;171;15;32
27.07.2023 12:00;74;88;12;5;23;9;21;46;20;20;;44;28;28;162;17;32
27.07.2023 13:00;67;134;17;4;24;22;28;54;38;13;;74;31;33;201;21;46
27.07.2023 14:00;75;167;12;20;19;26;17;59;39;9;;86;32;38;242;32;45
27.07.2023 15:00;96;187;25;14;44;30;15;48;35;18;;67;34;37;283;39;74
27.07.2023 16:00;105;211;51;26;69;35;33;64;60;19;;105;40;48;316;77;104
27.07.2023 17:00;151;259;33;10;83;50;27;78;92;19;;140;41;75;410;43;133
27.07.2023 18:00;110;243;34;12;54;29;14;51;61;17;;100;33;60;353;46;83
27.07.2023 19:00;100;185;16;5;34;19;9;22;47;17;;52;15;47;285;21;53
27.07.2023 20:00;50;116;14;5;11;17;2;15;18;14;;25;7;24;166;19;28
27.07.2023 21:00;48;95;2;5;10;12;2;19;15;7;;19;12;20;143;7;22
27.07.2023 22:00;26;53;4;4;8;5;2;4;18;4;;21;1;13;79;8;13
27.07.2023 23:00;21;47;4;0;6;2;0;3;4;6;;5;0;3;68;4;8
28.07.2023 00:00;5;22;4;0;4;0;0;1;1;7;;5;0;2;27;4;4
28.07.2023 01:00;5;7;0;1;1;0;0;2;2;0;;0;0;1;12;1;1
28.07.2023 02:00;4;4;0;0;2;0;1;0;1;0;;0;0;0;8;0;2
28.07.2023 03:00;0;4;0;1;3;0;0;0;2;1;;0;0;1;4;1;3
28.07.2023 04:00;8;10;2;2;1;3;0;1;2;1;;2;2;2;18;4;4
28.07.2023 05:00;31;32;10;9;13;7;1;8;8;0;;9;4;6;63;19;20
28.07.2023 06:00;71;68;14;19;36;26;14;21;13;2;;37;16;16;139;33;62
28.07.2023 07:00;160;155;28;28;65;60;21;50;57;15;;83;35;45;315;56;125
28.07.2023 08:00;188;179;30;14;80;69;19;78;82;27;;145;53;61;367;44;149
28.07.2023 09:00;148;165;24;12;50;46;70;75;63;22;;101;39;57;313;36;96
28.07.2023 10:00;110;156;39;15;52;25;58;83;80;18;;89;84;64;266;54;77
28.07.2023 11:00;146;210;28;26;46;44;61;125;84;33;;152;103;86;356;54;90
28.07.2023 12:00;117;249;53;20;34;38;44;93;90;19;;116;91;88;366;73;72
28.07.2023 13:00;152;253;46;28;50;45;38;78;81;29;;133;66;85;405;74;95
28.07.2023 14:00;136;283;62;30;75;79;85;71;98;35;;176;68;89;419;92;154
28.07.2023 15:00;170;273;56;37;85;79;57;144;130;30;;169;121;102;443;93;164
28.07.2023 16:00;105;257;21;24;63;50;42;81;93;22;;136;69;80;362;45;113
28.07.2023 17:00;169;302;60;23;81;64;48;124;120;50;;192;98;128;471;83;145
28.07.2023 18:00;176;264;63;22;100;78;46;106;126;49;;170;80;137;440;85;178
28.07.2023 19:00;141;196;48;14;80;75;26;85;107;22;;128;54;103;337;62;155
28.07.2023 20:00;114;176;34;20;64;54;26;84;96;26;;128;64;118;290;54;118
28.07.2023 21:00;104;117;19;10;79;36;9;45;83;22;;78;51;68;221;29;115
28.07.2023 22:00;51;129;14;7;70;17;4;26;42;13;;76;24;27;180;21;87
28.07.2023 23:00;46;91;12;4;27;11;1;8;20;7;;33;6;26;137;16;38
29.07.2023 00:00;18;58;5;3;9;6;1;3;9;2;;6;6;9;76;8;15
29.07.2023 01:00;10;31;6;4;7;2;1;3;3;1;;4;1;2;41;10;9
29.07.2023 02:00;5;20;3;9;2;5;0;0;4;2;;6;0;4;25;12;7
29.07.2023 03:00;6;12;1;2;2;1;0;0;2;0;;1;0;2;18;3;3
29.07.2023 04:00;5;13;1;0;4;3;0;8;2;0;;6;1;2;18;1;7
29.07.2023 05:00;9;11;0;3;6;8;1;1;2;1;;3;1;1;20;3;14
29.07.2023 06:00;10;18;4;2;4;2;2;3;6;1;;6;5;5;28;6;6
29.07.2023 07:00;25;27;8;6;4;11;2;9;14;4;;13;9;12;52;14;15
29.07.2023 08:00;40;69;11;8;21;11;3;19;35;13;;28;15;26;109;19;32
29.07.2023 09:00;87;119;43;19;30;20;20;29;38;19;;55;31;50;206;62;50
29.07.2023 10:00;130;184;32;24;36;41;29;117;101;36;;144;98;109;314;56;77
29.07.2023 11:00;129;228;41;27;52;48;53;118;131;52;;159;119;135;357;68;100
29.07.2023 12:00;124;166;35;16;33;33;51;81;90;34;;106;94;86;290;51;66
29.07.2023 13:00;88;192;15;14;24;50;19;71;95;23;;149;37;73;280;29;74
29.07.2023 14:00;157;177;44;22;66;54;74;108;105;33;;211;95;118;334;66;120
29.07.2023 15:00;119;193;26;26;75;69;56;144;142;26;;199;102;121;312;52;144
29.07.2023 16:00;108;198;26;17;67;88;37;80;127;24;;142;56;86;306;43;155
29.07.2023 17:00;101;184;31;4;60;77;30;112;97;16;;186;106;63;285;35;137
29.07.2023 18:00;64;139;15;5;31;31;19;57;55;20;;95;48;48;203;20;62
29.07.2023 19:00;92;132;21;9;59;40;19;55;64;14;;80;49;45;224;30;99
29.07.2023 20:00;81;97;25;10;55;36;29;69;72;23;;94;57;44;178;35;91
29.07.2023 21:00;58;102;12;7;87;29;9;49;56;17;;78;29;48;160;19;116
29.07.2023 22:00;48;84;11;5;112;116;5;46;141;16;;292;25;65;132;16;228
29.07.2023 23:00;29;81;6;0;27;19;9;16;18;2;;117;14;21;110;6;46
30.07.2023 00:00;21;55;6;2;6;4;0;2;2;2;;7;5;7;76;8;10
30.07.2023 01:00;16;39;3;4;5;3;2;4;5;0;;13;2;4;55;7;8
30.07.2023 02:00;9;23;3;2;9;2;2;0;2;0;;2;0;1;32;5;11
30.07.2023 03:00;3;17;1;6;5;6;0;2;2;0;;4;0;3;20;7;11
30.07.2023 04:00;9;12;1;0;3;2;1;2;1;0;;2;1;1;21;1;5
30.07.2023 05:00;9;11;4;5;6;5;5;2;3;1;;4;0;1;20;9;11
30.07.2023 06:00;9;15;10;2;9;3;2;9;9;1;;10;6;5;24;12;12
30.07.2023 07:00;19;16;20;14;21;15;9;23;25;5;;21;9;20;35;34;36
30.07.2023 08:00;22;45;15;6;14;18;6;17;31;8;;40;29;24;67;21;32
30.07.2023 09:00;39;69;17;17;16;17;24;33;46;7;;54;31;50;108;34;33
30.07.2023 10:00;87;112;43;31;48;52;70;99;96;37;;128;80;81;199;74;100
30.07.2023 11:00;114;118;101;54;77;85;146;178;173;45;;242;143;150;232;155;162
30.07.2023 12:00;129;155;86;69;132;81;135;282;248;49;;254;227;209;284;155;213
30.07.2023 13:00;153;181;121;70;111;125;170;259;276;54;;297;238;283;334;191;236
30.07.2023 14:00;204;299;141;90;187;176;199;372;395;59;;408;300;324;503;231;363
30.07.2023 15:00;230;300;112;57;208;146;190;372;397;78;;435;278;336;530;169;354
30.07.2023 16:00;174;282;94;62;174;151;160;315;371;67;;334;275;358;456;156;325
30.07.2023 17:00;202;264;87;60;186;147;142;289;395;66;;367;249;354;466;147;333
30.07.2023 18:00;202;274;87;51;144;113;88;228;315;65;;277;151;282;476;138;257
30.07.2023 19:00;204;225;62;35;99;96;119;178;227;51;;194;138;207;429;97;195
30.07.2023 20:00;101;143;34;14;55;28;18;53;78;29;;97;42;94;244;48;83
30.07.2023 21:00;59;65;12;8;22;18;12;21;45;10;;38;23;34;124;20;40
30.07.2023 22:00;37;53;2;6;17;7;3;5;17;7;;9;5;16;90;8;24
30.07.2023 23:00;15;24;3;1;4;1;2;2;7;5;;2;2;9;39;4;5
31.07.2023 00:00;23;19;0;3;6;5;3;3;1;0;;2;0;9;42;3;11
31.07.2023 01:00;7;11;0;2;4;0;1;0;2;0;;0;0;1;18;2;4
31.07.2023 02:00;3;5;1;0;0;1;0;0;1;0;;0;0;0;8;1;1
31.07.2023 03:00;4;7;1;0;2;0;0;0;1;0;;1;0;0;11;1;2
31.07.2023 04:00;5;6;2;1;7;2;0;4;2;1;;4;2;1;11;3;9
31.07.2023 05:00;42;42;19;14;24;13;2;6;9;1;;15;4;7;84;33;37
31.07.2023 06:00;130;119;28;28;62;45;20;44;49;14;;61;30;43;249;56;107
31.07.2023 07:00;285;256;62;41;152;116;41;85;130;40;;173;50;107;541;103;268
31.07.2023 08:00;256;208;45;24;120;115;24;83;110;29;;214;45;96;464;69;235
31.07.2023 09:00;141;177;35;10;53;65;16;89;70;17;;161;56;52;318;45;118
31.07.2023 10:00;73;112;15;6;18;20;25;49;21;18;;54;52;23;185;21;38
31.07.2023 11:00;72;130;20;13;24;24;30;60;37;12;;71;69;46;202;33;48
31.07.2023 12:00;111;200;16;11;31;42;40;57;60;24;;88;62;60;311;27;73
31.07.2023 13:00;138;223;31;9;44;27;29;87;80;32;;134;80;69;361;40;71
31.07.2023 14:00;149;270;47;17;66;55;39;104;89;34;;138;94;99;419;64;121
31.07.2023 15:00;175;327;65;36;105;71;48;108;131;42;;175;80;139;502;101;176
31.07.2023 16:00;221;455;94;44;153;98;81;166;174;57;;231;121;166;676;138;251
31.07.2023 17:00;229;438;68;36;156;117;38;133;189;50;;277;85;178;667;104;273
31.07.2023 18:00;123;327;48;21;72;49;28;67;76;40;;126;58;94;450;69;121
31.07.2023 19:00;124;216;27;10;29;29;6;26;57;27;;75;20;72;340;37;58
31.07.2023 20:00;67;127;9;9;15;25;4;20;19;11;;37;11;17;194;18;40
31.07.2023 21:00;47;86;11;4;7;5;3;7;10;2;;19;3;12;133;15;12
31.07.2023 22:00;37;62;4;0;12;5;1;3;5;4;;8;1;3;99;4;17
31.07.2023 23:00;16;33;2;4;7;1;0;3;4;0;;6;0;5;49;6;8
01.08.2023 00:00;8;12;2;0;4;7;0;0;1;4;;0;0;0;20;2;11
01.08.2023 01:00;6;11;1;0;0;2;0;0;0;0;;1;0;1;17;1;2
01.08.2023 02:00;3;5;0;0;2;0;0;6;2;0;;0;0;0;8;0;2
01.08.2023 03:00;1;6;0;0;2;1;0;2;2;0;;0;1;0;7;0;3
01.08.2023 04:00;2;6;1;0;3;1;0;2;1;0;;2;2;1;8;1;4
01.08.2023 05:00;28;26;9;12;15;9;5;5;4;1;;16;2;3;54;21;24
01.08.2023 06:00;117;106;25;33;58;48;13;28;38;7;;56;19;39;223;58;106
01.08.2023 07:00;289;250;49;49;133;114;52;77;116;32;;168;45;97;539;98;247
01.08.2023 08:00;343;349;67;28;215;207;44;134;197;44;;331;68;169;692;95;422
01.08.2023 09:00;199;240;30;24;88;63;47;73;93;37;;197;43;75;439;54;151
01.08.2023 10:00;155;212;26;31;56;45;39;88;91;32;;134;96;93;367;57;101
01.08.2023 11:00;154;219;44;24;45;51;59;113;107;34;;153;90;90;373;68;96
01.08.2023 12:00;177;237;34;14;66;63;28;104;122;26;;107;75;116;414;48;129
01.08.2023 13:00;172;283;43;22;56;66;42;109;107;43;;187;91;127;455;65;122
01.08.2023 14:00;136;280;31;23;80;72;41;101;118;24;;130;64;98;416;54;152
01.08.2023 15:00;210;360;61;24;121;87;55;111;161;52;;190;90;155;570;85;208
01.08.2023 16:00;269;470;105;55;168;137;78;166;213;57;;273;127;196;739;160;305
01.08.2023 17:00;249;477;84;50;212;180;65;211;229;67;;333;121;179;726;134;392
01.08.2023 18:00;229;445;66;35;131;98;32;84;153;53;;202;105;153;674;101;229
01.08.2023 19:00;158;295;32;17;66;68;34;80;97;48;;141;60;122;453;49;134
01.08.2023 20:00;88;164;25;9;64;26;12;43;61;30;;61;35;44;252;34;90
01.08.2023 21:00;64;141;20;4;33;18;3;14;33;21;;38;16;50;205;24;51
01.08.2023 22:00;71;106;7;4;33;16;2;14;32;21;;35;7;30;177;11;49
01.08.2023 23:00;21;64;6;5;8;2;0;6;7;8;;6;5;10;85;11;10
02.08.2023 00:00;6;18;1;2;1;7;0;1;1;1;;1;0;1;24;3;8
02.08.2023 01:00;4;18;6;0;2;0;0;3;0;0;;1;0;6;22;6;2
02.08.2023 02:00;7;19;1;0;5;0;1;1;1;0;;0;0;1;26;1;5
02.08.2023 03:00;1;7;0;0;1;0;0;0;2;0;;0;1;0;8;0;1
02.08.2023 04:00;11;7;1;1;7;3;0;1;2;0;;3;2;1;18;2;10
02.08.2023 05:00;42;35;11;7;18;12;1;5;12;2;;15;2;12;77;18;30
02.08.2023 06:00;109;121;29;32;71;34;26;37;36;9;;54;17;32;230;61;105
02.08.2023 07:00;244;223;34;36;82;94;28;53;93;29;;130;33;80;467;70;176
02.08.2023 08:00;232;239;42;27;122;93;24;58;99;24;;201;31;88;471;69;215
02.08.2023 09:00;147;164;26;3;55;39;21;50;35;22;;115;20;39;311;29;94
02.08.2023 10:00;107;142;26;10;34;25;29;37;36;17;;48;31;37;249;36;59
02.08.2023 11:00;63;127;7;7;17;22;22;33;46;13;;62;36;39;190;14;39
02.08.2023 12:00;108;167;20;7;32;31;37;46;53;18;;85;22;51;275;27;63
02.08.2023 13:00;96;211;33;19;40;36;49;65;75;14;;110;60;82;307;52;76
02.08.2023 14:00;113;218;26;23;65;46;40;87;98;23;;119;63;79;331;49;111
02.08.2023 15:00;155;265;42;20;99;58;33;105;97;36;;152;69;92;420;62;157
02.08.2023 16:00;204;402;80;37;118;79;26;118;148;38;;196;82;140;606;117;197
02.08.2023 17:00;172;384;59;34;144;85;32;127;165;30;;235;114;150;556;93;229
02.08.2023 18:00;200;418;69;46;118;100;38;161;179;45;;247;128;181;618;115;218
02.08.2023 19:00;110;252;34;11;38;64;21;81;90;25;;117;47;76;362;45;102
02.08.2023 20:00;103;187;24;14;55;33;6;45;73;21;;99;38;76;290;38;88
02.08.2023 21:00;82;151;22;3;42;34;11;31;43;15;;75;25;43;233;25;76
02.08.2023 22:00;63;117;10;3;22;30;1;19;31;6;;120;12;23;180;13;52
02.08.2023 23:00;34;50;7;0;5;7;1;8;7;0;;11;5;8;84;7;12
03.08.2023 00:00;15;24;6;2;6;5;0;1;6;4;;10;3;5;39;8;11
03.08.2023 01:00;7;21;0;0;1;2;0;1;0;1;;4;0;1;28;0;3
03.08.2023 02:00;3;9;1;0;1;2;0;0;2;1;;0;0;0;12;1;3
03.08.2023 03:00;2;6;1;0;1;0;0;0;0;0;;0;0;0;8;1;1
03.08.2023 04:00;8;13;1;2;8;2;0;2;2;0;;2;3;2;21;3;10
03.08.2023 05:00;24;30;10;8;21;8;1;8;8;2;;10;3;7;54;18;29
03.08.2023 06:00;73;94;20;23;44;32;18;27;25;8;;42;34;24;167;43;76
03.08.2023 07:00;208;199;43;46;92;99;33;72;87;30;;142;52;78;407;89;191
03.08.2023 08:00;328;305;80;36;191;145;43;114;194;55;;289;61;168;633;116;336
03.08.2023 09:00;201;202;37;21;72;70;31;79;75;28;;149;63;84;403;58;142
03.08.2023 10:00;113;160;28;16;38;42;22;72;87;31;;98;56;80;273;44;80
03.08.2023 11:00;95;174;23;11;42;35;28;68;45;24;;104;48;39;269;34;77
03.08.2023 12:00;94;185;19;11;42;36;33;63;43;17;;85;57;39;279;30;78
03.08.2023 13:00;102;228;42;9;42;29;45;49;62;31;;110;20;68;330;51;71
03.08.2023 14:00;130;280;48;24;69;70;52;87;104;34;;165;69;96;410;72;139
03.08.2023 15:00;196;359;67;19;104;76;41;99;104;43;;159;97;111;555;86;180
03.08.2023 16:00;233;571;76;38;143;102;65;115;175;64;;233;76;147;804;114;245
03.08.2023 17:00;226;559;83;37;149;110;41;118;173;44;;278;79;144;785;120;259
03.08.2023 18:00;191;434;54;25;124;90;34;129;141;58;;201;102;149;625;79;214
03.08.2023 19:00;123;231;24;16;66;52;18;47;70;32;;116;31;71;354;40;118
03.08.2023 20:00;108;198;28;13;46;44;6;26;56;27;;75;24;61;306;41;90
03.08.2023 21:00;120;151;6;8;41;18;7;31;33;45;;51;21;40;271;14;59
03.08.2023 22:00;293;125;19;17;48;19;9;11;26;61;;44;8;31;418;36;67
03.08.2023 23:00;60;71;10;3;10;12;4;7;12;9;;21;4;16;131;13;22
04.08.2023 00:00;17;23;3;0;6;4;1;1;6;2;;12;1;8;40;3;10
04.08.2023 01:00;7;16;1;0;2;3;0;0;4;0;;0;1;4;23;1;5
04.08.2023 02:00;2;17;1;0;1;1;1;1;1;0;;3;0;2;19;1;2
04.08.2023 03:00;3;7;1;1;3;1;1;0;1;0;;4;0;1;10;2;4
04.08.2023 04:00;8;11;1;0;5;5;1;3;3;2;;1;1;1;19;1;10
04.08.2023 05:00;36;42;6;10;18;11;1;10;10;4;;10;5;13;78;16;29
04.08.2023 06:00;95;97;38;30;54;38;23;41;42;14;;50;29;33;192;68;92
04.08.2023 07:00;210;205;48;44;83;73;31;79;88;21;;122;55;76;415;92;156
04.08.2023 08:00;256;257;48;33;110;95;33;77;120;29;;189;42;102;513;81;205
04.08.2023 09:00;173;196;56;26;74;62;26;68;73;30;;128;48;79;369;82;136
04.08.2023 10:00;179;196;30;18;34;39;36;90;94;31;;135;91;91;375;48;73
04.08.2023 11:00;137;236;39;16;55;56;23;81;114;42;;136;56;116;373;55;111
04.08.2023 12:00;179;293;36;21;54;38;56;114;106;28;;112;78;97;472;57;92
04.08.2023 13:00;222;351;59;20;69;47;48;104;130;37;;163;92;107;573;79;116
04.08.2023 14:00;195;431;55;48;84;75;53;123;124;46;;195;98;133;626;103;159
04.08.2023 15:00;202;454;70;40;121;102;85;130;175;70;;206;94;159;656;110;223
04.08.2023 16:00;210;462;83;58;121;101;72;153;231;70;;292;132;199;672;141;222
04.08.2023 17:00;246;453;89;41;165;165;75;225;248;73;;434;162;216;699;130;330
04.08.2023 18:00;201;375;77;28;155;159;40;149;158;49;;250;107;144;576;105;314
04.08.2023 19:00;149;302;39;24;88;77;22;93;109;28;;168;46;116;451;63;165
04.08.2023 20:00;137;214;22;13;69;51;21;55;90;40;;99;53;96;351;35;120
04.08.2023 21:00;98;180;18;10;60;50;11;45;49;29;;92;35;71;278;28;110
04.08.2023 22:00;103;243;23;16;111;96;5;48;67;30;;305;27;44;346;39;207
04.08.2023 23:00;316;157;18;5;55;27;10;9;25;68;;81;4;30;473;23;82
05.08.2023 00:00;37;68;7;5;13;5;2;5;16;12;;17;9;4;105;12;18
05.08.2023 01:00;15;46;0;3;7;1;4;1;5;5;;8;0;3;61;3;8
05.08.2023 02:00;11;25;1;0;7;2;2;0;2;2;;6;0;1;36;1;9
05.08.2023 03:00;4;6;1;0;2;0;0;1;1;0;;1;0;0;10;1;2
05.08.2023 04:00;5;6;1;0;1;2;0;1;1;0;;2;1;1;11;1;3
05.08.2023 05:00;10;20;4;5;5;1;3;6;5;1;;5;2;4;30;9;6
05.08.2023 06:00;9;15;9;1;6;12;1;7;14;2;;11;10;8;24;10;18
05.08.2023 07:00;18;30;5;3;21;9;9;14;28;4;;23;15;19;48;8;30
05.08.2023 08:00;52;79;21;18;29;26;17;37;37;16;;48;32;35;131;39;55
05.08.2023 09:00;129;181;39;24;50;39;45;98;87;31;;90;72;87;310;63;89
05.08.2023 10:00;191;283;72;36;75;60;95;185;172;68;;213;148;170;474;108;135
05.08.2023 11:00;201;324;93;44;132;118;77;212;285;63;;258;186;248;525;137;250
05.08.2023 12:00;258;380;95;52;145;110;118;257;260;77;;293;177;241;638;147;255
05.08.2023 13:00;215;467;76;52;124;128;118;238;344;71;;326;197;327;682;128;252
05.08.2023 14:00;219;354;76;43;136;101;76;239;240;45;;278;199;268;573;119;237
05.08.2023 15:00;138;386;40;17;106;89;69;164;175;43;;193;141;145;524;57;195
05.08.2023 16:00;165;316;42;19;83;66;39;175;150;57;;176;133;180;481;61;149
05.08.2023 17:00;135;290;37;17;51;54;35;103;92;39;;128;66;112;425;54;105
05.08.2023 18:00;124;277;20;16;53;45;22;72;71;22;;103;52;107;401;36;98
05.08.2023 19:00;113;174;19;17;40;17;16;34;41;17;;57;55;73;287;36;57
05.08.2023 20:00;73;123;21;6;31;8;7;42;38;15;;45;27;33;196;27;39
05.08.2023 21:00;57;96;14;3;34;9;8;19;23;15;;32;16;22;153;17;43
05.08.2023 22:00;69;88;4;4;38;21;2;14;26;10;;32;9;22;157;8;59
05.08.2023 23:00;295;81;14;7;24;11;4;7;25;58;;10;13;25;376;21;35
06.08.2023 00:00;64;62;8;0;22;8;4;9;7;13;;13;6;11;126;8;30
06.08.2023 01:00;33;21;7;4;5;3;0;5;6;1;;13;1;7;54;11;8
06.08.2023 02:00;25;11;1;1;5;2;0;0;5;6;;2;0;4;36;2;7
06.08.2023 03:00;8;26;4;1;2;4;0;3;1;0;;5;0;1;34;5;6
06.08.2023 04:00;7;9;2;0;2;2;0;2;2;0;;3;0;1;16;2;4
06.08.2023 05:00;13;7;3;1;3;2;0;2;1;1;;3;2;2;20;4;5
06.08.2023 06:00;9;15;4;0;3;4;2;2;12;0;;8;3;5;24;4;7
06.08.2023 07:00;7;17;4;2;8;4;1;5;7;0;;9;2;7;24;6;12
06.08.2023 08:00;19;31;4;2;8;7;5;8;11;9;;17;15;10;50;6;15
06.08.2023 09:00;29;75;9;8;10;23;17;34;37;13;;60;28;33;104;17;33
06.08.2023 10:00;78;123;35;24;23;30;51;70;76;14;;63;36;90;201;59;53
06.08.2023 11:00;58;89;21;13;33;22;45;66;59;16;;82;48;47;147;34;55
06.08.2023 12:00;42;68;11;9;28;20;15;47;39;15;;70;32;39;110;20;48
06.08.2023 13:00;35;63;7;2;12;8;12;24;13;4;;28;16;13;98;9;20
06.08.2023 14:00;51;55;4;8;11;13;9;30;16;4;;49;16;13;106;12;24
06.08.2023 15:00;37;61;9;7;6;10;3;20;13;9;;26;26;15;98;16;16
06.08.2023 16:00;43;60;20;1;14;7;16;15;20;10;;36;10;17;103;21;21
06.08.2023 17:00;64;91;15;3;24;27;15;30;36;22;;47;19;48;155;18;51
06.08.2023 18:00;78;86;18;6;25;53;13;50;66;14;;86;24;54;164;24;78
06.08.2023 19:00;51;82;3;7;11;20;3;14;23;18;;25;16;17;133;10;31
06.08.2023 20:00;34;43;11;1;5;8;0;8;6;7;;16;3;3;77;12;13
06.08.2023 21:00;25;38;5;2;7;20;2;8;16;6;;30;6;8;63;7;27
06.08.2023 22:00;17;28;4;1;5;2;2;1;4;4;;6;0;3;45;5;7
06.08.2023 23:00;8;21;2;1;3;5;0;0;3;1;;3;1;2;29;3;8
07.08.2023 00:00;2;7;3;0;2;3;0;0;3;0;;3;0;0;9;3;5
07.08.2023 01:00;5;5;1;0;1;0;0;2;2;0;;0;0;0;10;1;1
07.08.2023 02:00;4;0;4;0;0;0;0;0;1;0;;1;0;1;4;4;0
07.08.2023 03:00;1;1;0;1;2;0;0;0;1;0;;0;0;0;2;1;2
07.08.2023 04:00;6;9;2;2;4;1;1;1;0;0;;4;1;0;15;4;5
07.08.2023 05:00;23;28;6;7;20;6;3;8;4;0;;16;2;5;51;13;26
07.08.2023 06:00;90;78;17;25;44;33;18;18;30;9;;37;18;29;168;42;77
07.08.2023 07:00;331;304;65;47;121;122;33;70;122;32;;173;47;133;635;112;243
07.08.2023 08:00;290;303;46;26;145;145;37;84;119;34;;255;40;83;593;72;290
07.08.2023 09:00;106;155;19;4;44;39;8;41;39;14;;70;21;31;261;23;83
07.08.2023 10:00;89;121;8;10;18;21;11;29;18;19;;49;25;14;210;18;39
07.08.2023 11:00;79;133;15;10;29;24;23;31;32;14;;47;26;27;212;25;53
07.08.2023 12:00;101;192;21;16;32;32;34;41;53;21;;83;37;53;293;37;64
07.08.2023 13:00;129;237;39;10;53;51;35;73;67;31;;112;45;78;366;49;104
07.08.2023 14:00;190;283;35;24;61;61;34;83;126;31;;131;73;112;473;59;122
07.08.2023 15:00;221;371;72;26;101;83;38;113;121;47;;190;95;139;592;98;184
07.08.2023 16:00;273;465;76;43;149;129;61;134;196;69;;219;102;175;738;119;278
07.08.2023 17:00;250;573;87;40;167;105;56;179;221;70;;335;115;219;823;127;272
07.08.2023 18:00;230;446;103;35;141;119;47;152;219;67;;238;118;252;676;138;260
07.08.2023 19:00;218;320;58;36;93;81;27;118;159;62;;171;89;226;538;94;174
07.08.2023 20:00;126;237;49;28;44;57;22;70;94;26;;114;55;89;363;77;101
07.08.2023 21:00;91;169;22;7;34;30;11;26;60;24;;55;26;54;260;29;64
07.08.2023 22:00;71;122;14;9;25;9;0;11;23;9;;23;8;34;193;23;34
07.08.2023 23:00;22;34;9;5;8;6;1;7;6;3;;7;3;9;56;14;14
08.08.2023 00:00;11;15;5;5;3;2;0;0;;2;;2;0;2;26;10;5
08.08.2023 01:00;2;10;1;3;0;1;0;0;;2;;1;1;0;12;4;1
08.08.2023 02:00;6;2;1;0;2;1;3;0;;1;;0;0;0;8;1;3
08.08.2023 03:00;2;5;0;1;2;0;0;0;;0;;2;0;0;7;1;2
08.08.2023 04:00;6;9;3;1;4;3;0;1;;0;;3;1;2;15;4;7
08.08.2023 05:00;42;39;18;10;21;7;7;11;;3;;17;2;8;81;28;28
08.08.2023 06:00;152;156;34;51;87;49;25;45;;14;;84;38;49;308;85;136
08.08.2023 07:00;465;417;113;107;210;198;76;153;;65;;282;95;216;882;220;408
08.08.2023 08:00;466;449;78;46;243;276;48;185;;72;;462;84;257;915;124;519
08.08.2023 09:00;229;267;30;20;97;93;33;109;;38;;205;60;87;496;50;190
08.08.2023 10:00;151;222;37;27;59;50;36;115;;31;;153;94;88;373;64;109
08.08.2023 11:00;169;244;31;24;49;77;50;145;;38;;172;109;139;413;55;126
08.08.2023 12:00;163;330;57;16;65;83;50;126;;58;;188;107;119;493;73;148
08.08.2023 13:00;211;423;65;45;96;81;62;198;;45;;231;117;135;634;110;177
08.08.2023 14:00;191;390;70;39;90;63;74;128;;68;;212;95;168;581;109;153
08.08.2023 15:00;241;472;78;46;145;118;61;161;;63;;240;130;145;713;124;263
08.08.2023 16:00;292;572;108;49;214;150;77;197;;78;;347;125;183;864;157;364
08.08.2023 17:00;277;611;107;57;225;205;79;175;;79;;375;137;251;888;164;430
08.08.2023 18:00;276;566;86;49;180;135;67;155;;69;;259;133;287;842;135;315
08.08.2023 19:00;215;336;42;26;83;80;31;112;;62;;177;80;180;551;68;163
08.08.2023 20:00;122;225;27;25;88;45;22;77;;35;;120;53;106;347;52;133
08.08.2023 21:00;111;179;18;13;54;25;10;43;;15;;50;31;65;290;31;79
08.08.2023 22:00;65;128;8;8;30;14;5;14;;10;;30;8;31;193;16;44
08.08.2023 23:00;24;48;10;0;10;6;2;2;;7;;5;0;4;72;10;16
09.08.2023 00:00;12;16;3;0;3;0;1;0;;1;;2;0;3;28;3;3
09.08.2023 01:00;6;9;1;1;0;0;0;0;;0;;1;0;0;15;2;0
09.08.2023 02:00;3;3;0;0;1;0;2;0;;0;;2;0;0;6;0;1
09.08.2023 03:00;0;3;5;0;3;0;0;0;;0;;1;0;0;3;5;3
09.08.2023 04:00;2;6;0;0;4;2;1;2;;0;;3;2;0;8;0;6
09.08.2023 05:00;28;27;10;2;19;11;4;4;;1;;14;3;8;55;12;30
09.08.2023 06:00;109;105;29;45;50;29;22;22;;15;;47;22;34;214;74;79
09.08.2023 07:00;408;338;91;64;156;144;50;78;;67;;221;43;187;746;155;300
09.08.2023 08:00;441;431;64;58;242;249;61;151;;59;;415;58;176;872;122;491
09.08.2023 09:00;255;281;48;19;103;96;35;90;;30;;197;49;85;536;67;199
09.08.2023 10:00;169;245;37;32;62;55;51;102;;43;;128;74;98;414;69;117
09.08.2023 11:00;160;308;52;44;76;78;70;123;;41;;174;99;146;468;96;154
09.08.2023 12:00;185;321;69;37;78;79;67;178;;50;;194;123;139;506;106;157
09.08.2023 13:00;193;390;71;27;120;90;81;173;;58;;199;142;182;583;98;210
09.08.2023 14:00;221;423;81;60;119;98;77;162;;61;;273;160;202;644;141;217
09.08.2023 15:00;251;469;111;53;163;140;82;252;;76;;284;204;201;720;164;303
09.08.2023 16:00;284;592;152;53;215;161;119;260;;87;;383;194;334;876;205;376
09.08.2023 17:00;340;684;129;80;275;232;112;292;;120;;446;186;380;1024;209;507
09.08.2023 18:00;333;591;146;73;216;198;89;243;;122;;416;165;336;924;219;414
09.08.2023 19:00;273;446;71;50;181;154;70;195;;83;;304;142;311;719;121;335
09.08.2023 20:00;203;333;70;43;126;87;36;128;;48;;212;102;209;536;113;213
09.08.2023 21:00;178;212;49;12;71;55;12;66;;33;;134;51;114;390;61;126
09.08.2023 22:00;132;220;12;10;79;36;14;18;;15;;91;15;65;352;22;115
09.08.2023 23:00;46;85;11;2;12;2;1;4;;7;;14;3;17;131;13;14
10.08.2023 00:00;19;25;3;2;9;2;0;3;;2;;4;3;2;44;5;11
10.08.2023 01:00;4;12;1;0;1;2;0;0;;0;;3;0;0;16;1;3
10.08.2023 02:00;2;7;1;0;0;3;0;1;;0;;3;0;0;9;1;3
10.08.2023 03:00;0;3;1;0;4;0;0;1;;0;;4;0;0;3;1;4
10.08.2023 04:00;9;11;6;2;11;4;1;3;;1;;3;2;2;20;8;15
10.08.2023 05:00;46;33;20;10;21;15;3;10;;7;;17;10;13;79;30;36
10.08.2023 06:00;173;162;63;60;91;58;31;57;;14;;81;32;59;335;123;149
10.08.2023 07:00;543;443;137;99;230;233;91;173;;104;;317;93;284;986;236;463
10.08.2023 08:00;546;491;98;62;283;292;75;211;;70;;483;108;233;1037;160;575
10.08.2023 09:00;260;311;61;27;134;120;59;135;;52;;279;93;124;571;88;254
10.08.2023 10:00;206;284;50;36;87;75;74;179;;42;;207;131;150;490;86;162
10.08.2023 11:00;207;301;78;52;127;96;108;222;;36;;286;182;219;508;130;223
10.08.2023 12:00;242;353;88;62;126;85;141;241;;67;;281;255;215;595;150;211
10.08.2023 13:00;242;480;117;68;150;124;123;279;;89;;293;216;268;722;185;274
10.08.2023 14:00;255;462;91;60;174;170;125;310;;74;;328;244;287;717;151;344
10.08.2023 15:00;339;595;142;65;228;166;151;309;;109;;411;272;380;934;207;394
10.08.2023 16:00;394;702;199;116;291;220;167;377;;132;;501;253;429;1096;315;511
10.08.2023 17:00;457;863;160;93;326;295;158;350;;138;;665;249;486;1320;253;621
10.08.2023 18:00;430;747;162;61;292;267;128;343;;137;;644;228;471;1177;223;559
10.08.2023 19:00;289;544;112;75;203;213;91;247;;90;;445;159;314;833;187;416
10.08.2023 20:00;251;372;79;35;173;134;59;177;;69;;271;113;251;623;114;307
10.08.2023 21:00;192;265;44;19;121;76;45;83;;60;;189;79;172;457;63;197
10.08.2023 22:00;163;331;29;18;102;109;8;69;;26;;386;41;116;494;47;211
10.08.2023 23:00;54;160;14;3;31;18;2;15;;13;;69;9;34;214;17;49
11.08.2023 00:00;33;52;9;3;8;2;2;14;;1;;17;9;17;85;12;10
11.08.2023 01:00;6;24;4;1;2;1;0;0;;0;;9;1;7;30;5;3
11.08.2023 02:00;4;14;3;0;4;1;0;0;;0;;4;3;4;18;3;5
11.08.2023 03:00;3;10;6;0;2;0;0;2;;0;;3;0;0;13;6;2
11.08.2023 04:00;6;15;5;2;11;3;1;3;;1;;3;2;1;21;7;14
11.08.2023 05:00;36;33;21;8;16;14;6;7;;3;;20;4;8;69;29;30
11.08.2023 06:00;147;141;56;46;71;53;25;49;;14;;69;32;57;288;102;124
11.08.2023 07:00;428;370;117;96;194;142;64;142;;87;;235;79;229;798;213;336
11.08.2023 08:00;377;397;75;53;172;208;89;154;;42;;348;82;165;774;128;380
11.08.2023 09:00;239;272;46;43;105;86;67;153;;48;;210;101;144;511;89;191
11.08.2023 10:00;185;276;51;24;84;81;78;172;;39;;197;117;153;461;75;165
11.08.2023 11:00;211;286;94;45;94;82;115;263;;60;;291;191;211;497;139;176
11.08.2023 12:00;288;414;108;53;130;98;122;287;;76;;350;255;282;702;161;228
11.08.2023 13:00;296;568;126;56;172;119;128;327;;111;;329;275;309;864;182;291
11.08.2023 14:00;269;568;129;73;187;176;159;296;;96;;362;257;315;837;202;363
11.08.2023 15:00;303;578;164;88;221;152;149;332;;101;;394;236;349;881;252;373
11.08.2023 16:00;336;570;125;69;184;171;160;325;;95;;436;242;335;906;194;355
11.08.2023 17:00;330;564;107;76;251;158;122;287;;120;;418;238;348;894;183;409
11.08.2023 18:00;375;552;139;58;229;228;115;275;;91;;449;230;371;927;197;457
11.08.2023 19:00;297;551;123;58;210;138;82;252;;123;;354;203;334;848;181;348
11.08.2023 20:00;238;353;62;27;149;104;35;203;;53;;218;132;219;591;89;253
11.08.2023 21:00;181;273;46;19;130;102;29;101;;45;;182;80;170;454;65;232
11.08.2023 22:00;193;282;42;24;153;89;13;86;;40;;317;56;128;475;66;242
11.08.2023 23:00;124;228;26;6;72;42;5;22;;23;;73;28;74;352;32;114
12.08.2023 00:00;89;147;11;16;30;18;6;11;;20;;46;7;46;236;27;48
12.08.2023 01:00;35;80;3;11;10;4;2;7;;3;;11;2;8;115;14;14
12.08.2023 02:00;19;27;4;0;2;1;0;2;;6;;8;1;4;46;4;3
12.08.2023 03:00;5;14;4;0;1;0;0;1;;1;;3;0;3;19;4;1
12.08.2023 04:00;2;7;1;0;4;1;0;3;;0;;1;0;1;9;1;5
12.08.2023 05:00;8;11;5;1;2;7;3;4;;3;;9;3;2;19;6;9
12.08.2023 06:00;12;27;11;4;9;12;4;9;;1;;11;10;11;39;15;21
12.08.2023 07:00;16;24;17;6;19;14;7;10;;4;;23;9;13;40;23;33
12.08.2023 08:00;24;40;7;12;14;10;7;15;;4;;22;15;14;64;19;24
12.08.2023 09:00;75;112;19;7;14;12;12;31;;17;;44;19;28;187;26;26
12.08.2023 10:00;114;141;23;26;24;17;40;48;;31;;67;43;54;255;49;41
12.08.2023 11:00;144;282;36;23;39;27;64;97;;52;;119;94;120;426;59;66
12.08.2023 12:00;187;255;56;24;59;42;76;126;;49;;183;75;132;442;80;101
12.08.2023 13:00;164;269;51;38;52;64;91;124;;41;;125;115;125;433;89;116
12.08.2023 14:00;159;265;61;33;54;52;88;142;;42;;201;98;137;424;94;106
12.08.2023 15:00;163;288;39;25;77;59;69;160;;46;;203;137;112;451;64;136
12.08.2023 16:00;181;276;42;30;75;83;81;199;;54;;240;165;181;457;72;158
12.08.2023 17:00;162;326;58;21;77;141;82;153;;36;;330;80;126;488;79;218
12.08.2023 18:00;148;270;51;30;72;118;75;154;;41;;239;101;154;418;81;190
12.08.2023 19:00;174;278;47;21;64;96;42;116;;58;;177;89;153;452;68;160
12.08.2023 20:00;130;193;37;30;60;58;26;96;;26;;148;63;84;323;67;118
12.08.2023 21:00;99;200;18;19;79;64;19;44;;12;;133;39;70;299;37;143
12.08.2023 22:00;82;214;17;5;82;91;11;71;;11;;304;49;40;296;22;173
12.08.2023 23:00;74;135;9;14;19;14;14;13;;13;;55;8;34;209;23;33
13.08.2023 00:00;33;88;16;5;12;11;3;11;;7;;13;6;12;121;21;23
13.08.2023 01:00;37;64;6;4;15;14;4;6;;3;;13;5;10;101;10;29
13.08.2023 02:00;29;46;3;0;3;7;2;2;;2;;11;0;8;75;3;10
13.08.2023 03:00;13;20;5;0;3;4;0;1;;3;;6;1;5;33;5;7
13.08.2023 04:00;5;8;2;1;2;2;0;2;;0;;1;1;5;13;3;4
13.08.2023 05:00;7;12;3;1;2;4;1;4;;3;;1;1;2;19;4;6
13.08.2023 06:00;13;15;10;6;4;5;2;8;;0;;4;4;6;28;16;9
13.08.2023 07:00;22;43;18;11;12;17;9;23;;4;;33;13;27;65;29;29
13.08.2023 08:00;50;49;39;7;46;46;17;41;;20;;60;45;50;99;46;92
13.08.2023 09:00;121;119;55;29;66;49;72;123;;31;;122;164;103;240;84;115
13.08.2023 10:00;179;191;92;59;109;106;135;246;;58;;216;201;205;370;151;215
13.08.2023 11:00;205;268;114;60;129;133;242;391;;92;;371;289;347;473;174;262
13.08.2023 12:00;256;336;141;79;197;155;302;427;;107;;460;370;458;592;220;352
13.08.2023 13:00;268;323;158;104;240;188;302;485;;125;;479;310;475;591;262;428
13.08.2023 14:00;283;460;162;128;262;215;286;555;;135;;585;354;503;743;290;477
13.08.2023 15:00;292;464;148;106;262;201;333;520;;89;;568;356;486;756;254;463
13.08.2023 16:00;268;434;122;73;214;211;248;410;;109;;512;317;483;702;195;425
13.08.2023 17:00;262;516;149;57;219;142;186;433;;99;;444;341;419;778;206;361
13.08.2023 18:00;302;384;104;74;175;142;139;320;;97;;385;251;361;686;178;317
13.08.2023 19:00;257;355;82;63;123;120;106;222;;56;;261;171;291;612;145;243
13.08.2023 20:00;189;212;52;38;92;109;42;156;;59;;186;83;204;401;90;201
13.08.2023 21:00;124;141;18;15;59;35;21;60;;19;;112;43;86;265;33;94
13.08.2023 22:00;65;110;10;5;48;32;3;15;;7;;84;8;43;175;15;80
13.08.2023 23:00;27;52;2;1;11;7;1;7;;9;;17;2;18;79;3;18
14.08.2023 00:00;8;18;2;0;7;1;1;3;;2;;8;4;4;26;2;8
14.08.2023 01:00;10;12;0;1;1;4;0;3;;3;;2;0;2;22;1;5
14.08.2023 02:00;2;5;0;0;3;1;1;0;;2;;0;0;0;7;0;4
14.08.2023 03:00;0;4;3;1;2;0;1;0;;0;;2;0;0;4;4;2
14.08.2023 04:00;7;9;7;3;6;10;1;2;;0;;4;4;2;16;10;16
14.08.2023 05:00;55;46;13;12;26;8;8;7;;7;;25;8;15;101;25;34
14.08.2023 06:00;179;145;50;61;77;57;36;57;;17;;89;29;66;324;111;134
14.08.2023 07:00;524;431;130;119;227;210;95;161;;72;;293;95;215;955;249;437
14.08.2023 08:00;505;454;91;54;279;271;66;208;;72;;487;91;219;959;145;550
14.08.2023 09:00;243;278;50;26;127;111;32;130;;37;;207;78;127;521;76;238
14.08.2023 10:00;175;257;48;30;60;72;53;133;;30;;179;102;126;432;78;132
14.08.2023 11:00;174;262;49;39;75;75;82;117;;40;;164;93;159;436;88;150
14.08.2023 12:00;183;344;64;38;86;79;90;173;;40;;222;132;149;527;102;165
14.08.2023 13:00;125;316;59;28;58;58;51;110;;36;;153;71;82;441;87;116
14.08.2023 14:00;182;317;57;19;88;58;53;79;;27;;154;82;81;499;76;146
14.08.2023 15:00;266;404;91;37;137;110;74;173;;54;;266;146;173;670;128;247
14.08.2023 16:00;307;598;132;76;210;170;109;205;;100;;301;139;255;905;208;380
14.08.2023 17:00;324;706;117;62;258;165;98;247;;95;;405;169;318;1030;179;423
14.08.2023 18:00;273;552;118;48;206;152;88;240;;92;;363;133;315;825;166;358
14.08.2023 19:00;257;447;85;37;107;130;51;141;;74;;226;94;307;704;122;237
14.08.2023 20:00;200;307;59;32;85;63;42;131;;43;;193;93;209;507;91;148
14.08.2023 21:00;127;186;24;22;45;40;17;58;;27;;78;31;85;313;46;85
14.08.2023 22:00;63;130;9;11;22;14;2;14;;11;;16;10;33;193;20;36
14.08.2023 23:00;34;99;5;3;7;9;3;8;;5;;22;6;24;133;8;16
15.08.2023 00:00;13;16;4;1;7;5;1;4;;1;;8;2;4;29;5;12
15.08.2023 01:00;6;12;3;0;4;2;2;0;;0;;0;2;1;18;3;6
15.08.2023 02:00;5;6;0;0;0;0;0;0;;0;;1;0;1;11;0;0
15.08.2023 03:00;1;4;2;0;0;2;1;2;;0;;2;0;0;5;2;2
15.08.2023 04:00;6;6;3;0;7;3;0;2;;1;;3;3;2;12;3;10
15.08.2023 05:00;15;12;2;0;8;7;0;0;;0;;3;1;2;27;2;15
15.08.2023 06:00;95;95;26;23;29;26;8;16;;6;;37;17;18;190;49;55
15.08.2023 07:00;479;384;90;77;170;192;69;117;;69;;223;75;208;863;167;362
15.08.2023 08:00;446;434;82;50;306;285;53;209;;77;;480;83;197;880;132;591
15.08.2023 09:00;241;271;79;25;128;104;50;114;;33;;245;61;104;512;104;232
15.08.2023 10:00;128;192;33;26;50;38;68;76;;35;;98;87;81;320;59;88
15.08.2023 11:00;169;210;33;27;65;70;68;124;;22;;139;96;90;379;60;135
15.08.2023 12:00;145;295;47;28;77;56;65;125;;51;;187;115;89;440;75;133
15.08.2023 13:00;205;358;81;26;102;62;74;163;;71;;212;106;144;563;107;164
15.08.2023 14:00;225;366;63;27;117;92;67;138;;45;;200;109;168;591;90;209
15.08.2023 15:00;224;437;80;45;130;100;86;141;;63;;234;117;138;661;125;230
15.08.2023 16:00;279;553;96;60;165;158;88;181;;64;;324;121;213;832;156;323
15.08.2023 17:00;311;633;91;76;277;210;89;230;;91;;418;143;263;944;167;487
15.08.2023 18:00;294;575;117;50;196;172;83;226;;83;;370;158;317;869;167;368
15.08.2023 19:00;268;416;110;30;185;123;51;164;;63;;269;119;277;684;140;308
15.08.2023 20:00;206;292;54;40;132;107;37;147;;48;;190;113;226;498;94;239
15.08.2023 21:00;140;231;27;18;91;49;15;95;;41;;106;55;97;371;45;140
15.08.2023 22:00;103;217;21;10;96;29;6;28;;23;;74;22;68;320;31;125
15.08.2023 23:00;36;68;7;5;16;6;2;23;;4;;26;7;11;104;12;22
16.08.2023 00:00;18;35;1;2;9;4;0;0;;1;;9;7;4;53;3;13
16.08.2023 01:00;8;14;0;0;2;2;0;1;;2;;4;0;1;22;0;4
16.08.2023 02:00;9;4;0;1;0;0;0;2;;1;;4;0;0;13;1;0
16.08.2023 03:00;4;4;1;2;1;0;0;0;;0;;0;2;0;8;3;1
16.08.2023 04:00;11;7;4;2;4;7;0;4;;0;;4;3;2;18;6;11
16.08.2023 05:00;48;41;9;8;29;10;4;4;;2;;17;2;18;89;17;39
16.08.2023 06:00;157;133;49;65;91;56;32;53;;19;;95;31;66;290;114;147
16.08.2023 07:00;486;409;103;105;237;211;78;159;;73;;289;90;264;895;208;448
16.08.2023 08:00;476;401;93;42;278;260;90;189;;74;;488;94;182;877;135;538
16.08.2023 09:00;243;242;63;20;100;90;40;108;;31;;206;60;123;485;83;190
16.08.2023 10:00;162;202;38;22;53;62;50;109;;45;;127;97;100;364;60;115
16.08.2023 11:00;174;252;55;33;60;67;72;139;;47;;166;108;112;426;88;127
16.08.2023 12:00;179;313;57;30;77;82;73;162;;36;;196;133;136;492;87;159
16.08.2023 13:00;173;367;79;26;116;74;56;140;;49;;183;119;142;540;105;190
16.08.2023 14:00;206;437;69;62;122;124;76;166;;55;;206;165;217;643;131;246
16.08.2023 15:00;237;452;105;52;215;155;99;218;;76;;284;162;231;689;157;370
16.08.2023 16:00;316;583;168;73;247;209;136;256;;99;;416;177;321;899;241;456
16.08.2023 17:00;328;665;108;76;285;233;109;233;;111;;458;163;344;993;184;518
16.08.2023 18:00;335;634;125;52;216;157;75;214;;111;;365;175;299;969;177;373
16.08.2023 19:00;282;434;84;38;128;115;50;179;;72;;229;118;240;716;122;243
16.08.2023 20:00;211;310;54;23;99;67;40;85;;45;;174;79;143;521;77;166
16.08.2023 21:00;103;162;17;8;37;21;4;12;;13;;31;18;23;265;25;58
16.08.2023 22:00;87;176;25;11;37;12;7;19;;11;;55;6;32;263;36;49
16.08.2023 23:00;34;91;6;3;10;6;3;3;;3;;11;4;14;125;9;16
17.08.2023 00:00;18;23;2;0;2;0;2;3;;4;;6;2;4;41;2;2
17.08.2023 01:00;9;10;1;0;1;3;0;1;;0;;2;1;3;19;1;4
17.08.2023 02:00;6;10;0;0;0;0;1;3;;0;;6;0;0;16;0;0
17.08.2023 03:00;1;2;1;1;0;0;0;1;;1;;1;1;0;3;2;0
17.08.2023 04:00;5;7;7;1;3;3;1;0;;2;;3;1;2;12;8;6
17.08.2023 05:00;45;35;12;10;27;14;6;10;;2;;17;4;13;80;22;41
17.08.2023 06:00;148;120;35;52;70;39;20;47;;12;;74;32;44;268;87;109
17.08.2023 07:00;464;387;99;79;167;205;63;161;;76;;254;82;224;851;178;372
17.08.2023 08:00;444;413;84;41;275;221;65;176;;55;;410;74;185;857;125;496
17.08.2023 09:00;239;226;48;32;84;99;51;99;;41;;183;41;100;465;80;183
17.08.2023 10:00;139;208;28;28;54;56;53;121;;28;;137;80;95;347;56;110
17.08.2023 11:00;153;257;31;22;48;63;62;132;;29;;156;107;104;410;53;111
17.08.2023 12:00;182;316;41;31;80;50;73;105;;44;;176;92;127;498;72;130
17.08.2023 13:00;177;386;69;27;118;84;61;123;;57;;186;84;136;563;96;202
17.08.2023 14:00;207;431;64;29;114;96;76;194;;59;;231;150;163;638;93;210
17.08.2023 15:00;265;459;117;57;150;104;61;183;;62;;262;173;241;724;174;254
17.08.2023 16:00;332;568;112;74;211;176;91;212;;96;;359;169;312;900;186;387
17.08.2023 17:00;343;670;138;67;273;209;112;256;;96;;433;152;298;1013;205;482
17.08.2023 18:00;287;625;101;62;252;176;111;218;;97;;375;167;289;912;163;428
17.08.2023 19:00;261;493;87;38;248;149;47;208;;66;;369;144;284;754;125;397
17.08.2023 20:00;203;319;59;42;149;98;37;133;;66;;192;83;172;522;101;247
17.08.2023 21:00;154;225;26;17;95;57;21;86;;33;;134;53;90;379;43;152
17.08.2023 22:00;88;219;16;10;123;30;8;19;;10;;100;12;81;307;26;153
17.08.2023 23:00;38;141;7;4;32;20;1;7;;12;;43;9;20;179;11;52
18.08.2023 00:00;21;31;4;2;7;3;2;4;;3;;7;0;6;52;6;10
18.08.2023 01:00;6;15;0;0;1;1;0;0;;0;;2;0;1;21;0;2
18.08.2023 02:00;2;5;0;0;0;1;1;0;;0;;1;0;0;7;0;1
18.08.2023 03:00;8;11;1;0;3;0;0;0;;0;;1;0;0;19;1;3
18.08.2023 04:00;6;10;4;2;5;4;2;1;;2;;8;2;2;16;6;9
18.08.2023 05:00;50;43;17;11;20;16;3;11;;5;;13;9;6;93;28;36
18.08.2023 06:00;126;106;31;41;63;44;31;41;;7;;51;28;48;232;72;107
18.08.2023 07:00;372;369;98;96;171;153;62;115;;80;;200;75;213;741;194;324
18.08.2023 08:00;373;367;57;39;155;155;51;138;;53;;275;84;149;740;96;310
18.08.2023 09:00;239;272;55;32;100;75;38;125;;48;;173;73;117;511;87;175
18.08.2023 10:00;181;235;59;25;65;71;59;149;;29;;161;128;130;416;84;136
18.08.2023 11:00;201;327;72;35;109;63;82;181;;35;;194;152;182;528;107;172
18.08.2023 12:00;234;388;82;61;102;93;108;222;;67;;257;184;190;622;143;195
18.08.2023 13:00;302;491;97;77;152;104;120;240;;81;;306;180;275;793;174;256
18.08.2023 14:00;257;551;124;65;145;123;108;252;;87;;329;197;271;808;189;268
18.08.2023 15:00;271;491;134;74;198;140;127;298;;74;;350;217;261;762;208;338
18.08.2023 16:00;280;532;137;63;180;144;115;252;;91;;365;205;312;812;200;324
18.08.2023 17:00;308;524;115;61;208;141;101;272;;100;;332;231;270;832;176;349
18.08.2023 18:00;308;518;114;61;206;132;91;296;;93;;342;239;312;826;175;338
18.08.2023 19:00;325;425;76;55;156;107;77;198;;78;;289;147;303;750;131;263
18.08.2023 20:00;227;305;51;46;126;85;48;155;;82;;188;104;222;532;97;211
18.08.2023 21:00;136;235;23;25;116;53;32;81;;47;;135;84;149;371;48;169
18.08.2023 22:00;165;265;28;9;97;33;18;57;;32;;108;28;89;430;37;130
18.08.2023 23:00;83;161;10;9;61;39;11;28;;24;;59;9;68;244;19;100
19.08.2023 00:00;56;139;13;4;26;13;2;18;;8;;35;6;22;195;17;39
19.08.2023 01:00;25;68;6;0;9;4;2;8;;4;;15;4;7;93;6;13
19.08.2023 02:00;5;40;3;1;7;1;3;6;;4;;8;3;1;45;4;8
19.08.2023 03:00;8;19;3;1;7;1;4;0;;0;;4;2;2;27;4;8
19.08.2023 04:00;13;12;3;0;3;3;0;2;;0;;2;1;2;25;3;6
19.08.2023 05:00;10;17;5;3;13;9;4;12;;4;;4;8;2;27;8;22
19.08.2023 06:00;13;14;5;8;23;19;3;16;;3;;31;7;16;27;13;42
19.08.2023 07:00;24;42;16;11;47;39;19;25;;10;;74;19;47;66;27;86
19.08.2023 08:00;92;97;36;28;57;97;33;63;;22;;147;55;79;189;64;154
19.08.2023 09:00;158;151;44;26;89;105;67;125;;39;;218;115;119;309;70;194
19.08.2023 10:00;200;249;81;35;107;118;96;196;;48;;295;166;171;449;116;225
19.08.2023 11:00;176;272;79;40;150;149;115;250;;61;;336;197;208;448;119;299
19.08.2023 12:00;214;354;67;53;123;157;123;233;;58;;391;182;201;568;120;280
19.08.2023 13:00;234;365;100;41;136;132;123;310;;72;;435;213;266;599;141;268
19.08.2023 14:00;213;326;99;57;146;158;140;233;;49;;410;197;204;539;156;304
19.08.2023 15:00;149;312;87;59;126;120;108;249;;62;;306;215;205;461;146;246
19.08.2023 16:00;133;275;63;26;102;107;81;199;;47;;240;147;143;408;89;209
19.08.2023 17:00;149;252;48;37;106;75;69;130;;54;;194;110;163;401;85;181
19.08.2023 18:00;196;310;51;38;105;72;68;176;;47;;204;112;189;506;89;177
19.08.2023 19:00;171;268;53;7;101;64;37;126;;36;;190;96;164;439;60;165
19.08.2023 20:00;139;286;39;18;93;63;37;96;;52;;151;79;166;425;57;156
19.08.2023 21:00;104;198;40;23;77;47;32;69;;41;;101;57;91;302;63;124
19.08.2023 22:00;78;213;22;5;78;32;26;39;;28;;110;28;83;291;27;110
19.08.2023 23:00;67;119;21;2;42;29;0;23;;10;;36;12;48;186;23;71
20.08.2023 00:00;50;113;14;2;23;8;4;17;;4;;35;8;19;163;16;31
20.08.2023 01:00;45;83;17;2;11;6;5;7;;5;;12;6;14;128;19;17
20.08.2023 02:00;18;41;5;0;10;2;2;4;;2;;4;1;3;59;5;12
20.08.2023 03:00;6;24;3;6;2;3;5;2;;2;;7;0;4;30;9;5
20.08.2023 04:00;3;11;6;2;2;2;1;4;;2;;4;0;1;14;8;4
20.08.2023 05:00;8;13;7;5;1;2;2;0;;2;;3;4;4;21;12;3
20.08.2023 06:00;12;16;6;6;6;10;4;6;;1;;7;5;7;28;12;16
20.08.2023 07:00;18;22;16;6;19;24;13;19;;6;;33;22;29;40;22;43
20.08.2023 08:00;39;51;18;19;40;24;15;58;;7;;59;66;39;90;37;64
20.08.2023 09:00;90;159;73;42;84;51;65;132;;42;;148;122;113;249;115;135
20.08.2023 10:00;186;203;129;76;124;105;127;301;;62;;259;209;247;389;205;229
20.08.2023 11:00;200;235;154;74;148;171;196;349;;79;;413;333;348;435;228;319
20.08.2023 12:00;194;227;134;58;166;142;189;442;;112;;414;362;336;421;192;308
20.08.2023 13:00;197;271;157;95;166;139;176;417;;76;;426;335;323;468;252;305
20.08.2023 14:00;246;333;176;90;218;155;204;429;;89;;397;338;378;579;266;373
20.08.2023 15:00;249;321;142;73;191;168;198;342;;86;;473;323;394;570;215;359
20.08.2023 16:00;228;288;187;85;215;132;190;397;;94;;424;273;318;516;272;347
20.08.2023 17:00;235;323;144;89;204;135;158;368;;99;;392;322;333;558;233;339
20.08.2023 18:00;242;295;128;60;162;130;106;377;;79;;315;229;311;537;188;292
20.08.2023 19:00;201;282;80;47;97;120;84;255;;59;;272;188;256;483;127;217
20.08.2023 20:00;164;201;72;43;80;99;78;161;;42;;194;124;205;365;115;179
20.08.2023 21:00;96;165;31;17;49;42;20;75;;43;;113;42;129;261;48;91
20.08.2023 22:00;58;106;19;6;26;18;14;29;;8;;34;9;33;164;25;44
20.08.2023 23:00;25;70;3;2;14;10;3;15;;11;;20;5;15;95;5;24
21.08.2023 00:00;23;23;3;1;8;1;0;3;;2;;5;0;4;46;4;9
21.08.2023 01:00;9;8;0;2;0;1;0;1;;0;;2;0;3;17;2;1
21.08.2023 02:00;2;2;2;0;1;0;0;0;;0;;0;0;0;4;2;1
21.08.2023 03:00;2;7;6;2;1;0;0;0;;0;;0;0;0;9;8;1
21.08.2023 04:00;5;9;4;4;5;5;0;4;;1;;2;3;2;14;8;10
21.08.2023 05:00;57;47;24;14;19;19;6;9;;5;;22;5;12;104;38;38
21.08.2023 06:00;164;179;54;67;89;55;36;62;;21;;84;41;67;343;121;144
21.08.2023 07:00;500;421;120;111;251;231;87;174;;88;;323;106;273;921;231;482
21.08.2023 08:00;470;442;105;58;283;256;71;216;;73;;466;107;240;912;163;539
21.08.2023 09:00;279;289;40;37;113;101;50;131;;46;;235;87;132;568;77;214
21.08.2023 10:00;186;279;50;43;86;78;80;170;;54;;190;137;133;465;93;164
21.08.2023 11:00;193;279;67;43;85;62;90;216;;33;;183;177;164;472;110;147
21.08.2023 12:00;170;321;81;40;91;88;82;189;;47;;217;135;166;491;121;179
21.08.2023 13:00;205;397;116;57;134;75;96;222;;62;;247;147;183;602;173;209
21.08.2023 14:00;209;429;102;47;125;102;73;168;;59;;241;130;198;638;149;227
21.08.2023 15:00;267;506;117;36;193;144;74;235;;77;;298;161;217;773;153;337
21.08.2023 16:00;345;674;151;101;258;172;109;281;;92;;404;194;301;1019;252;430
21.08.2023 17:00;340;727;162;74;299;185;112;291;;108;;472;222;339;1067;236;484
21.08.2023 18:00;356;588;129;63;238;176;106;285;;117;;450;178;398;944;192;414
21.08.2023 19:00;278;421;97;64;134;148;72;197;;93;;245;108;343;699;161;282
21.08.2023 20:00;233;303;60;38;116;83;42;141;;70;;184;100;228;536;98;199
21.08.2023 21:00;139;270;50;14;72;50;23;73;;45;;110;54;147;409;64;122
21.08.2023 22:00;92;141;19;8;27;25;13;15;;31;;47;13;67;233;27;52
21.08.2023 23:00;49;58;9;9;10;6;2;18;;9;;24;6;22;107;18;16
22.08.2023 00:00;10;21;3;1;4;3;2;4;;0;;6;1;8;31;4;7
22.08.2023 01:00;12;13;0;1;1;3;2;4;;0;;1;0;8;25;1;4
22.08.2023 02:00;6;6;0;1;1;1;1;0;;5;;1;1;4;12;1;2
22.08.2023 03:00;2;8;1;0;1;0;2;1;;0;;0;1;0;10;1;1
22.08.2023 04:00;6;8;6;2;7;5;1;6;;0;;3;4;1;14;8;12
22.08.2023 05:00;63;45;26;18;31;12;6;10;;7;;15;6;16;108;44;43
22.08.2023 06:00;188;155;71;71;88;62;34;54;;22;;90;41;60;343;142;150
22.08.2023 07:00;591;475;132;109;245;249;102;224;;85;;381;128;293;1066;241;494
22.08.2023 08:00;553;520;106;58;332;298;88;279;;68;;539;105;244;1073;164;630
22.08.2023 09:00;268;317;65;46;134;152;84;164;;63;;272;91;146;585;111;286
22.08.2023 10:00;237;253;46;43;69;73;89;151;;42;;195;130;139;490;89;142
22.08.2023 11:00;219;308;67;47;92;70;118;213;;55;;213;156;187;527;114;162
22.08.2023 12:00;199;323;60;39;101;90;103;218;;60;;221;181;202;522;99;191
22.08.2023 13:00;233;455;82;50;129;98;111;226;;64;;314;165;211;688;132;227
22.08.2023 14:00;215;461;89;51;167;128;101;226;;57;;267;187;211;676;140;295
22.08.2023 15:00;334;572;134;53;211;151;138;274;;82;;361;181;245;906;187;362
22.08.2023 16:00;369;697;182;86;295;179;123;323;;87;;421;206;309;1066;268;474
22.08.2023 17:00;384;787;172;89;345;326;150;267;;138;;542;218;440;1171;261;671
22.08.2023 18:00;378;708;146;77;268;221;143;291;;109;;484;179;393;1086;223;489
22.08.2023 19:00;293;524;91;69;194;194;68;198;;92;;320;152;314;817;160;388
22.08.2023 20:00;218;324;80;64;155;107;47;129;;67;;190;118;227;542;144;262
22.08.2023 21:00;220;294;55;34;104;73;23;90;;45;;169;71;131;514;89;177
22.08.2023 22:00;100;198;26;14;71;31;9;34;;25;;81;15;62;298;40;102
22.08.2023 23:00;59;90;13;4;22;10;3;11;;10;;15;6;12;149;17;32
23.08.2023 00:00;20;31;2;1;5;1;0;3;;4;;9;1;8;51;3;6
23.08.2023 01:00;5;10;0;3;0;2;0;0;;1;;2;0;1;15;3;2
23.08.2023 02:00;7;5;2;0;0;0;1;0;;0;;0;1;1;12;2;0
23.08.2023 03:00;4;2;2;1;2;0;0;0;;0;;1;1;0;6;3;2
23.08.2023 04:00;10;12;7;3;4;4;1;1;;0;;4;2;2;22;10;8
23.08.2023 05:00;47;43;19;19;26;24;8;8;;6;;23;10;15;90;38;50
23.08.2023 06:00;172;159;52;71;75;53;39;66;;15;;97;39;58;331;123;128
23.08.2023 07:00;532;440;138;117;242;230;90;224;;100;;333;126;277;972;255;472
23.08.2023 08:00;560;483;107;63;335;298;73;287;;66;;565;119;285;1043;170;633
23.08.2023 09:00;276;327;63;39;154;128;56;165;;44;;264;93;152;603;102;282
23.08.2023 10:00;178;279;56;40;89;80;88;145;;50;;162;110;174;457;96;169
23.08.2023 11:00;235;331;73;33;108;93;85;190;;64;;246;177;211;566;106;201
23.08.2023 12:00;201;375;82;55;102;115;104;204;;81;;246;164;219;576;137;217
23.08.2023 13:00;220;470;109;28;151;106;108;235;;62;;281;157;206;690;137;257
23.08.2023 14:00;254;509;105;56;195;131;94;263;;66;;298;213;234;763;161;326
23.08.2023 15:00;281;536;180;67;209;176;114;260;;72;;368;211;256;817;247;385
23.08.2023 16:00;353;692;158;102;281;182;137;309;;94;;456;189;314;1045;260;463
23.08.2023 17:00;360;778;179;94;320;251;125;365;;122;;585;246;417;1138;273;571
23.08.2023 18:00;383;662;136;81;282;261;135;338;;120;;502;258;418;1045;217;543
23.08.2023 19:00;369;512;116;76;194;164;76;254;;74;;385;156;335;881;192;358
23.08.2023 20:00;295;369;85;74;161;107;58;206;;67;;233;140;296;664;159;268
23.08.2023 21:00;205;353;44;36;121;64;24;105;;52;;197;71;158;558;80;185
23.08.2023 22:00;153;256;33;7;76;31;9;36;;17;;88;21;87;409;40;107
23.08.2023 23:00;64;100;14;1;29;23;2;18;;6;;34;5;21;164;15;52
24.08.2023 00:00;19;38;8;3;10;7;1;5;;3;;7;1;15;57;11;17
24.08.2023 01:00;4;21;1;0;3;3;0;0;;2;;3;0;0;25;1;6
24.08.2023 02:00;4;7;1;0;1;0;1;2;;3;;3;1;0;11;1;1
24.08.2023 03:00;1;3;2;0;1;0;0;0;;0;;1;1;0;4;2;1
24.08.2023 04:00;6;8;5;3;6;3;0;6;;1;;3;4;0;14;8;9
24.08.2023 05:00;40;42;27;14;21;12;5;11;;4;;24;5;17;82;41;33
24.08.2023 06:00;142;118;46;47;82;37;20;40;;9;;70;36;34;260;93;119
24.08.2023 07:00;375;277;80;68;128;142;54;99;;59;;197;63;157;652;148;270
24.08.2023 08:00;450;448;75;58;268;260;63;220;;43;;428;66;179;898;133;528
24.08.2023 09:00;241;282;55;33;110;112;50;138;;33;;207;84;121;523;88;222
24.08.2023 10:00;210;236;47;46;72;73;72;159;;47;;167;113;131;446;93;145
24.08.2023 11:00;192;290;52;30;84;54;105;199;;33;;211;118;133;482;82;138
24.08.2023 12:00;155;328;73;43;93;80;90;182;;49;;224;111;170;483;116;173
24.08.2023 13:00;201;428;76;38;133;103;93;179;;43;;227;126;196;629;114;236
24.08.2023 14:00;178;396;59;36;120;85;45;159;;37;;227;106;133;574;95;205
24.08.2023 15:00;208;411;96;29;141;121;65;133;;61;;227;72;142;619;125;262
24.08.2023 16:00;289;510;94;63;233;181;76;181;;67;;506;119;189;799;157;414
24.08.2023 17:00;192;411;51;33;241;172;41;139;;43;;365;58;125;603;84;413
24.08.2023 18:00;152;362;56;24;112;64;26;71;;36;;148;41;85;514;80;176
24.08.2023 19:00;164;346;32;21;231;110;19;89;;44;;287;62;122;510;53;341
24.08.2023 20:00;122;212;43;24;170;93;21;67;;29;;300;52;119;334;67;263
24.08.2023 21:00;105;189;20;4;102;45;13;40;;18;;108;30;67;294;24;147
24.08.2023 22:00;75;162;16;6;52;22;5;9;;13;;80;9;47;237;22;74
24.08.2023 23:00;34;67;7;0;21;10;0;6;;3;;20;2;18;101;7;31
25.08.2023 00:00;24;35;4;0;6;6;1;6;;0;;3;1;6;59;4;12
25.08.2023 01:00;4;18;2;0;1;1;3;0;;5;;3;0;11;22;2;2
25.08.2023 02:00;12;10;2;2;4;0;1;0;;1;;2;0;0;22;4;4
25.08.2023 03:00;0;4;1;1;3;0;1;0;;0;;0;0;0;4;2;3
25.08.2023 04:00;2;8;2;3;2;2;1;3;;0;;1;3;0;10;5;4
25.08.2023 05:00;35;40;12;8;11;17;3;7;;3;;14;2;8;75;20;28
25.08.2023 06:00;115;121;27;35;34;27;16;28;;7;;46;24;37;236;62;61
25.08.2023 07:00;354;274;70;65;154;135;40;113;;53;;175;75;165;628;135;289
25.08.2023 08:00;328;340;61;39;143;130;35;165;;40;;252;72;112;668;100;273
25.08.2023 09:00;179;222;33;16;73;60;40;69;;23;;132;30;66;401;49;133
25.08.2023 10:00;153;227;39;17;51;40;32;68;;29;;84;55;66;380;56;91
25.08.2023 11:00;102;214;20;12;39;29;21;49;;22;;90;40;65;316;32;68
25.08.2023 12:00;162;246;49;20;51;45;38;72;;21;;105;49;59;408;69;96
25.08.2023 13:00;181;335;52;20;75;37;19;75;;50;;110;38;92;516;72;112
25.08.2023 14:00;120;323;43;32;66;53;29;59;;22;;92;58;72;443;75;119
25.08.2023 15:00;174;332;61;39;79;66;45;110;;43;;131;64;106;506;100;145
25.08.2023 16:00;208;358;58;29;105;85;44;124;;37;;183;88;116;566;87;190
25.08.2023 17:00;214;361;51;29;111;98;40;96;;68;;202;103;112;575;80;209
25.08.2023 18:00;192;368;45;24;79;60;38;117;;46;;165;122;150;560;69;139
25.08.2023 19:00;215;311;42;26;95;78;34;93;;51;;163;80;160;526;68;173
25.08.2023 20:00;189;216;35;6;68;54;29;89;;18;;112;45;83;405;41;122
25.08.2023 21:00;126;179;14;8;61;35;6;36;;18;;61;28;90;305;22;96
25.08.2023 22:00;75;177;12;6;61;48;3;11;;15;;50;7;43;252;18;109
25.08.2023 23:00;41;111;8;1;17;23;1;9;;13;;49;8;42;152;9;40
26.08.2023 00:00;51;83;4;3;33;26;0;7;;10;;19;7;45;134;7;59
26.08.2023 01:00;34;41;4;4;28;23;2;4;;2;;14;2;26;75;8;51
26.08.2023 02:00;21;33;4;0;18;14;1;1;;1;;9;0;22;54;4;32
26.08.2023 03:00;21;22;0;4;8;14;0;1;;4;;9;1;17;43;4;22
26.08.2023 04:00;18;10;2;2;9;8;1;3;;0;;6;2;10;28;4;17
26.08.2023 05:00;12;18;7;3;8;8;3;2;;1;;10;0;12;30;10;16
26.08.2023 06:00;25;22;10;1;9;6;4;13;;0;;8;16;13;47;11;15
26.08.2023 07:00;36;38;14;12;10;15;13;19;;7;;41;20;20;74;26;25
26.08.2023 08:00;82;100;31;26;40;30;31;51;;16;;59;37;70;182;57;70
26.08.2023 09:00;147;144;91;23;45;41;41;108;;31;;130;87;84;291;114;86
26.08.2023 10:00;192;252;76;49;89;71;97;230;;50;;240;176;139;444;125;160
26.08.2023 11:00;229;347;101;57;100;105;122;252;;81;;271;214;257;576;158;205
26.08.2023 12:00;274;334;86;56;150;94;158;269;;106;;332;238;285;608;142;244
26.08.2023 13:00;243;469;137;64;133;96;183;332;;75;;340;259;318;712;201;229
26.08.2023 14:00;265;458;105;55;157;73;175;296;;90;;337;242;341;723;160;230
26.08.2023 15:00;290;495;102;65;158;99;144;356;;109;;351;287;372;785;167;257
26.08.2023 16:00;268;369;103;59;156;100;172;315;;83;;338;242;333;637;162;256
26.08.2023 17:00;275;418;85;51;132;146;128;319;;75;;351;238;294;693;136;278
26.08.2023 18:00;277;386;93;37;167;110;105;246;;80;;294;188;240;663;130;277
26.08.2023 19:00;287;349;63;27;132;106;81;175;;73;;249;134;214;636;90;238
26.08.2023 20:00;179;250;48;28;98;87;35;125;;39;;169;78;130;429;76;185
26.08.2023 21:00;143;194;30;28;99;30;21;47;;31;;92;37;87;337;58;129
26.08.2023 22:00;71;231;12;2;85;19;6;41;;22;;97;23;71;302;14;104
26.08.2023 23:00;70;126;9;8;51;20;3;16;;14;;44;15;60;196;17;71
27.08.2023 00:00;31;123;9;9;14;14;5;8;;12;;38;6;21;154;18;28
27.08.2023 01:00;21;72;7;5;9;6;2;6;;2;;16;2;15;93;12;15
27.08.2023 02:00;15;37;1;0;5;6;2;2;;0;;13;5;3;52;1;11
27.08.2023 03:00;13;22;4;1;4;3;0;3;;1;;6;2;7;35;5;7
27.08.2023 04:00;4;15;1;1;0;3;0;3;;0;;6;3;1;19;2;3
27.08.2023 05:00;10;21;4;2;3;4;2;1;;1;;2;1;2;31;6;7
27.08.2023 06:00;8;11;3;3;5;8;2;6;;2;;13;8;10;19;6;13
27.08.2023 07:00;22;19;16;4;14;13;14;17;;3;;26;13;18;41;20;27
27.08.2023 08:00;24;37;16;13;19;11;13;25;;5;;38;16;32;61;29;30
27.08.2023 09:00;64;80;43;36;56;44;24;91;;31;;91;71;76;144;79;100
27.08.2023 10:00;119;154;71;42;56;79;96;171;;38;;141;134;179;273;113;135
27.08.2023 11:00;103;173;84;35;98;106;118;197;;53;;181;165;191;276;119;204
27.08.2023 12:00;122;183;68;33;87;87;123;216;;58;;226;184;210;305;101;174
27.08.2023 13:00;198;253;88;64;140;116;145;205;;61;;259;152;257;451;152;256
27.08.2023 14:00;223;282;102;58;147;107;147;230;;48;;290;221;254;505;160;254
27.08.2023 15:00;180;257;92;54;175;130;164;302;;77;;306;241;264;437;146;305
27.08.2023 16:00;192;270;81;40;125;118;110;236;;70;;250;238;252;462;121;243
27.08.2023 17:00;241;277;71;48;115;105;99;165;;64;;241;177;223;518;119;220
27.08.2023 18:00;165;259;58;33;110;76;50;176;;57;;215;145;181;424;91;186
27.08.2023 19:00;139;202;52;29;56;76;41;103;;42;;135;74;137;341;81;132
27.08.2023 20:00;100;172;31;18;28;29;19;37;;30;;105;47;84;272;49;57
27.08.2023 21:00;87;113;11;13;22;13;14;18;;20;;51;24;46;200;24;35
27.08.2023 22:00;49;69;3;7;20;8;3;6;;6;;20;4;13;118;10;28
27.08.2023 23:00;20;32;11;4;8;2;2;1;;4;;1;0;6;52;15;10
28.08.2023 00:00;4;14;4;0;2;2;0;0;;0;;2;2;4;18;4;4
28.08.2023 01:00;1;4;5;5;1;0;0;1;;0;;1;0;0;5;10;1
28.08.2023 02:00;3;3;1;1;1;2;1;1;;0;;1;0;1;6;2;3
28.08.2023 03:00;3;3;1;0;3;0;0;0;;0;;0;0;0;6;1;3
28.08.2023 04:00;4;5;2;4;7;2;1;1;;1;;1;2;1;9;6;9
28.08.2023 05:00;48;54;20;18;26;17;7;6;;5;;19;4;14;102;38;43
28.08.2023 06:00;139;153;46;46;80;44;31;45;;13;;73;42;61;292;92;124
28.08.2023 07:00;471;390;109;106;227;216;81;167;;78;;260;104;235;861;215;443
28.08.2023 08:00;486;460;84;52;257;230;64;236;;70;;407;81;197;946;136;487
28.08.2023 09:00;246;278;59;20;113;86;41;108;;43;;214;72;99;524;79;199
28.08.2023 10:00;190;207;39;20;53;59;35;102;;36;;136;56;90;397;59;112
28.08.2023 11:00;169;267;38;31;69;62;57;131;;25;;144;109;122;436;69;131
28.08.2023 12:00;169;325;56;19;86;69;49;129;;44;;174;120;121;494;75;155
28.08.2023 13:00;186;406;71;29;106;82;81;145;;54;;213;110;188;592;100;188
28.08.2023 14:00;194;399;77;34;124;113;62;142;;48;;207;97;176;593;111;237
28.08.2023 15:00;255;439;76;34;153;112;89;172;;63;;250;154;162;694;110;265
28.08.2023 16:00;335;610;144;70;213;141;103;215;;92;;358;133;219;945;214;354
28.08.2023 17:00;332;684;131;72;257;182;107;239;;90;;450;159;318;1016;203;439
28.08.2023 18:00;292;566;103;50;159;165;90;244;;72;;329;143;317;858;153;324
28.08.2023 19:00;256;389;62;37;94;111;57;105;;68;;192;97;264;645;99;205
28.08.2023 20:00;183;288;44;25;83;68;16;88;;44;;145;62;125;471;69;151
28.08.2023 21:00;118;205;22;11;51;39;6;19;;21;;61;28;58;323;33;90
28.08.2023 22:00;73;139;21;9;21;19;7;11;;16;;31;4;17;212;30;40
28.08.2023 23:00;33;54;9;10;7;5;1;6;;4;;15;2;10;87;19;12
29.08.2023 00:00;10;25;8;0;6;1;1;3;;1;;5;4;3;35;8;7
29.08.2023 01:00;2;12;1;1;0;3;0;1;;2;;1;0;2;14;2;3
29.08.2023 02:00;2;7;1;2;0;0;0;0;;0;;1;0;3;9;3;0
29.08.2023 03:00;2;6;1;0;2;1;0;0;;2;;3;0;1;8;1;3
29.08.2023 04:00;6;9;3;3;5;3;0;1;;1;;3;2;1;15;6;8
29.08.2023 05:00;50;36;24;11;25;12;8;9;;4;;26;9;15;86;35;37
29.08.2023 06:00;168;155;62;53;73;40;28;35;;13;;67;32;48;323;115;113
29.08.2023 07:00;522;464;111;88;211;213;75;192;;79;;321;100;240;986;199;424
29.08.2023 08:00;498;447;98;40;295;271;73;240;;62;;467;101;214;945;138;566
29.08.2023 09:00;257;254;42;31;113;112;34;102;;36;;218;52;98;511;73;225
29.08.2023 10:00;168;223;26;28;67;62;46;91;;33;;120;70;103;391;54;129
29.08.2023 11:00;169;265;39;22;65;55;64;116;;32;;140;83;100;434;61;120
29.08.2023 12:00;201;271;58;23;92;66;58;124;;28;;184;102;131;472;81;158
29.08.2023 13:00;198;419;75;33;127;97;60;140;;46;;186;102;141;617;108;224
29.08.2023 14:00;206;446;71;44;107;116;72;118;;65;;226;92;198;652;115;223
29.08.2023 15:00;252;479;116;48;160;143;77;216;;67;;305;131;196;731;164;303
29.08.2023 16:00;332;621;127;56;260;174;89;229;;89;;377;182;257;953;183;434
29.08.2023 17:00;368;733;115;121;326;242;99;264;;109;;458;145;343;1101;236;568
29.08.2023 18:00;322;673;117;74;202;179;79;199;;93;;384;143;346;995;191;381
29.08.2023 19:00;284;439;109;38;160;111;49;159;;77;;263;109;239;723;147;271
29.08.2023 20:00;168;291;28;36;78;74;33;87;;46;;142;53;167;459;64;152
29.08.2023 21:00;125;219;24;7;45;35;3;31;;25;;70;29;82;344;31;80
29.08.2023 22:00;146;186;13;11;35;27;5;24;;8;;45;13;35;332;24;62
29.08.2023 23:00;39;56;6;1;11;6;1;4;;11;;11;1;13;95;7;17
30.08.2023 00:00;11;22;2;1;6;5;1;1;;0;;0;1;1;33;3;11
30.08.2023 01:00;8;14;2;1;2;2;1;1;;1;;4;0;1;22;3;4
30.08.2023 02:00;2;3;1;0;1;5;1;1;;0;;2;1;1;5;1;6
30.08.2023 03:00;0;6;3;0;3;1;0;1;;2;;1;1;1;6;3;4
30.08.2023 04:00;5;13;4;2;7;4;1;2;;2;;2;1;3;18;6;11
30.08.2023 05:00;43;37;15;16;29;12;6;9;;3;;21;3;17;80;31;41
30.08.2023 06:00;126;126;52;49;67;40;24;37;;6;;70;24;40;252;101;107
30.08.2023 07:00;440;378;88;82;199;180;59;147;;71;;263;95;228;818;170;379
30.08.2023 08:00;420;417;85;58;250;226;51;241;;51;;389;88;189;837;143;476
30.08.2023 09:00;242;301;46;16;92;113;46;123;;41;;209;76;137;543;62;205
30.08.2023 10:00;180;258;43;26;77;59;42;108;;34;;139;85;94;438;69;136
30.08.2023 11:00;158;277;41;34;70;64;75;126;;36;;176;110;141;435;75;134
30.08.2023 12:00;165;366;52;19;90;59;56;124;;54;;174;86;108;531;71;149
30.08.2023 13:00;152;312;67;10;90;71;40;85;;39;;129;83;108;464;77;161
30.08.2023 14:00;103;323;41;19;87;56;21;74;;25;;104;61;72;426;60;143
30.08.2023 15:00;155;351;47;22;112;70;28;97;;34;;145;59;88;506;69;182
30.08.2023 16:00;174;307;72;42;119;77;41;78;;32;;148;34;99;481;114;196
30.08.2023 17:00;198;456;63;26;178;116;30;95;;39;;208;53;123;654;89;294
30.08.2023 18:00;201;413;64;30;146;120;41;103;;35;;237;77;147;614;94;266
30.08.2023 19:00;164;284;30;23;58;55;29;97;;22;;131;46;93;448;53;113
30.08.2023 20:00;122;198;31;12;37;30;22;42;;23;;86;35;67;320;43;67
30.08.2023 21:00;84;141;11;2;24;18;5;25;;13;;42;15;29;225;13;42
30.08.2023 22:00;48;139;9;5;14;24;3;13;;2;;32;5;13;187;14;38
30.08.2023 23:00;36;41;11;5;7;8;2;5;;5;;16;0;7;77;16;15
31.08.2023 00:00;13;27;2;0;3;2;0;0;;1;;3;1;1;40;2;5
31.08.2023 01:00;2;8;2;0;4;0;0;1;;0;;4;1;0;10;2;4
31.08.2023 02:00;3;2;2;0;2;1;0;2;;1;;1;0;1;5;2;3
31.08.2023 03:00;0;7;3;0;2;1;0;0;;0;;1;1;0;7;3;3
31.08.2023 04:00;6;9;1;3;8;2;1;2;;0;;1;1;1;15;4;10
31.08.2023 05:00;45;31;16;8;24;12;5;8;;4;;14;3;14;76;24;36
31.08.2023 06:00;107;127;39;47;65;31;15;36;;6;;49;24;38;234;86;96
31.08.2023 07:00;496;371;89;72;203;193;61;171;;78;;295;78;208;867;161;396
31.08.2023 08:00;442;437;87;48;244;243;66;232;;57;;421;100;200;879;135;487
31.08.2023 09:00;251;263;48;29;119;105;54;126;;37;;222;78;125;514;77;224
31.08.2023 10:00;177;244;35;21;55;59;53;111;;33;;129;89;119;421;56;114
31.08.2023 11:00;174;278;38;30;75;61;72;155;;39;;180;116;135;452;68;136
31.08.2023 12:00;210;347;53;38;91;74;81;150;;45;;217;128;156;557;91;165
31.08.2023 13:00;225;409;71;33;115;98;62;118;;58;;187;98;150;634;104;213
31.08.2023 14:00;192;391;68;31;120;109;34;143;;38;;218;93;140;583;99;229
31.08.2023 15:00;253;460;100;30;164;105;71;171;;58;;241;110;184;713;130;269
31.08.2023 16:00;271;588;98;51;189;111;70;180;;69;;287;126;192;859;149;300
31.08.2023 17:00;306;589;86;54;258;217;85;196;;87;;362;135;231;895;140;475
31.08.2023 18:00;262;555;100;38;172;136;68;169;;67;;278;87;215;817;138;308
31.08.2023 19:00;208;398;58;29;88;81;34;131;;51;;193;77;164;606;87;169
31.08.2023 20:00;157;249;31;23;65;43;19;75;;35;;110;50;115;406;54;108
31.08.2023 21:00;81;159;19;10;34;20;5;31;;12;;46;27;33;240;29;54
31.08.2023 22:00;82;133;7;5;27;21;2;14;;12;;48;11;30;215;12;48
31.08.2023 23:00;30;71;8;0;7;11;4;1;;2;;14;1;16;101;8;18
01.09.2023 00:00;8;19;4;0;6;0;1;2;;3;;7;0;4;27;4;6
01.09.2023 01:00;5;16;0;0;2;1;0;0;;0;;2;1;2;21;0;3
01.09.2023 02:00;4;7;1;1;0;0;0;1;;0;;0;0;1;11;2;0
01.09.2023 03:00;4;6;4;0;2;1;1;1;;0;;1;1;1;10;4;3
01.09.2023 04:00;4;11;3;0;3;1;1;0;;3;;1;0;1;15;3;4
01.09.2023 05:00;26;41;17;4;17;13;2;5;;2;;15;3;10;67;21;30
01.09.2023 06:00;79;96;25;23;47;30;12;22;;5;;32;17;25;175;48;77
01.09.2023 07:00;311;286;65;52;113;115;32;86;;59;;147;51;128;597;117;228
01.09.2023 08:00;297;275;40;38;111;110;26;119;;37;;181;43;80;572;78;221
01.09.2023 09:00;106;121;12;7;28;31;8;28;;10;;60;19;25;227;19;59
01.09.2023 10:00;64;109;12;4;16;18;21;29;;5;;43;17;22;173;16;34
01.09.2023 11:00;86;146;16;6;19;16;22;39;;11;;51;32;43;232;22;35
01.09.2023 12:00;106;151;28;11;25;21;13;34;;14;;44;29;31;257;39;46
01.09.2023 13:00;108;250;28;5;58;32;23;29;;35;;58;23;64;358;33;90
01.09.2023 14:00;128;235;39;16;59;34;22;41;;38;;72;22;47;363;55;93
01.09.2023 15:00;132;255;48;23;73;54;24;87;;27;;97;37;53;387;71;127
01.09.2023 16:00;128;270;30;20;60;58;34;50;;27;;103;42;54;398;50;118
01.09.2023 17:00;141;319;38;25;78;67;39;61;;31;;107;77;71;460;63;145
01.09.2023 18:00;180;296;47;16;80;47;22;88;;23;;112;72;120;476;63;127
01.09.2023 19:00;158;255;41;24;50;39;30;57;;28;;92;53;93;413;65;89
01.09.2023 20:00;111;170;26;13;28;35;10;37;;16;;64;26;51;281;39;63
01.09.2023 21:00;80;136;13;3;17;9;6;15;;12;;30;11;26;216;16;26
01.09.2023 22:00;67;129;7;6;23;16;7;15;;6;;30;6;23;196;13;39
01.09.2023 23:00;45;107;12;7;14;6;2;6;;7;;25;8;15;152;19;20
02.09.2023 00:00;33;63;5;2;7;3;1;5;;8;;10;0;12;96;7;10
02.09.2023 01:00;9;42;3;4;4;2;3;1;;0;;11;2;1;51;7;6
02.09.2023 02:00;7;23;2;0;3;0;2;0;;0;;1;0;4;30;2;3
02.09.2023 03:00;7;15;2;0;2;2;0;1;;1;;2;0;0;22;2;4
02.09.2023 04:00;5;7;3;0;3;2;1;1;;0;;3;0;2;12;3;5
02.09.2023 05:00;4;14;3;0;4;2;1;2;;4;;1;3;2;18;3;6
02.09.2023 06:00;10;16;5;5;4;3;2;2;;0;;12;3;4;26;10;7
02.09.2023 07:00;15;31;10;8;13;12;11;13;;11;;20;8;21;46;18;25
02.09.2023 08:00;66;66;23;16;31;27;16;31;;24;;47;30;69;132;39;58
02.09.2023 09:00;123;181;35;19;56;33;35;66;;24;;80;55;82;304;54;89
02.09.2023 10:00;191;251;51;57;76;57;79;107;;44;;186;114;125;442;108;133
02.09.2023 11:00;277;337;76;45;127;129;101;189;;73;;264;164;213;614;121;256
02.09.2023 12:00;254;364;89;70;133;124;125;265;;57;;355;221;309;618;159;257
02.09.2023 13:00;323;468;92;57;163;118;149;300;;102;;441;215;301;791;149;281
02.09.2023 14:00;284;474;96;63;170;119;183;339;;87;;429;241;349;758;159;289
02.09.2023 15:00;257;510;94;60;186;89;186;306;;93;;382;250;354;767;154;275
02.09.2023 16:00;261;519;111;69;183;142;139;290;;93;;408;255;381;780;180;325
02.09.2023 17:00;231;464;84;58;235;156;121;277;;78;;331;204;373;695;142;391
02.09.2023 18:00;234;405;77;53;196;128;92;288;;61;;374;206;305;639;130;324
02.09.2023 19:00;201;385;52;42;126;79;95;182;;79;;308;115;247;586;94;205
02.09.2023 20:00;184;293;42;17;100;121;32;124;;60;;319;78;230;477;59;221
02.09.2023 21:00;106;187;23;23;43;35;19;46;;41;;79;31;104;293;46;78
02.09.2023 22:00;86;168;15;3;46;17;9;25;;14;;64;24;53;254;18;63
02.09.2023 23:00;79;95;10;6;40;22;10;20;;14;;56;4;35;174;16;62
03.09.2023 00:00;51;83;8;10;11;17;4;16;;13;;31;11;13;134;18;28
03.09.2023 01:00;35;58;4;4;13;13;2;6;;13;;46;0;13;93;8;26
03.09.2023 02:00;31;32;1;1;4;13;2;5;;9;;11;5;4;63;2;17
03.09.2023 03:00;16;19;3;0;1;0;3;1;;1;;2;0;5;35;3;1
03.09.2023 04:00;10;14;0;0;5;1;0;3;;3;;3;4;1;24;0;6
03.09.2023 05:00;8;16;2;0;4;4;2;0;;2;;3;1;4;24;2;8
03.09.2023 06:00;15;13;7;0;2;8;1;6;;3;;9;5;8;28;7;10
03.09.2023 07:00;20;21;13;14;17;12;11;17;;2;;26;13;14;41;27;29
03.09.2023 08:00;42;53;22;14;41;30;16;44;;11;;60;46;37;95;36;71
03.09.2023 09:00;83;139;53;34;74;29;63;78;;23;;94;66;92;222;87;103
03.09.2023 10:00;149;126;71;26;84;94;100;171;;33;;218;113;161;275;97;178
03.09.2023 11:00;127;162;83;54;135;144;138;258;;47;;256;206;202;289;137;279
03.09.2023 12:00;179;216;89;71;155;109;157;375;;61;;340;281;269;395;160;264
03.09.2023 13:00;219;308;140;81;164;152;184;379;;69;;399;293;338;527;221;316
03.09.2023 14:00;250;302;165;74;193;185;243;415;;107;;426;368;455;552;239;378
03.09.2023 15:00;264;359;149;85;257;195;208;480;;111;;475;371;437;623;234;452
03.09.2023 16:00;250;342;163;83;225;173;190;451;;117;;436;332;455;592;246;398
03.09.2023 17:00;264;320;108;70;248;195;147;397;;128;;422;288;497;584;178;443
03.09.2023 18:00;250;383;102;52;170;161;88;262;;83;;289;200;405;633;154;331
03.09.2023 19:00;214;276;66;51;111;88;80;203;;72;;224;139;268;490;117;199
03.09.2023 20:00;137;152;35;20;53;48;32;106;;44;;109;79;154;289;55;101
03.09.2023 21:00;111;142;16;15;31;25;9;29;;22;;58;18;53;253;31;56
03.09.2023 22:00;41;72;6;5;13;11;3;8;;6;;21;6;14;113;11;24
03.09.2023 23:00;12;44;1;1;9;13;2;3;;0;;25;4;9;56;2;22
04.09.2023 00:00;5;19;2;0;6;3;0;5;;0;;3;1;1;24;2;9
04.09.2023 01:00;4;7;1;1;1;0;0;1;;0;;1;0;3;11;2;1
04.09.2023 02:00;5;3;1;0;0;0;1;0;;0;;4;0;0;8;1;0
04.09.2023 03:00;2;7;4;1;4;1;1;0;;0;;0;0;0;9;5;5
04.09.2023 04:00;4;8;6;5;5;4;1;0;;0;;3;2;0;12;11;9
04.09.2023 05:00;40;48;15;10;30;16;4;11;;2;;17;6;15;88;25;46
04.09.2023 06:00;159;149;58;67;83;53;31;51;;10;;79;33;66;308;125;136
04.09.2023 07:00;502;432;108;110;230;229;97;174;;88;;308;103;228;934;218;459
04.09.2023 08:00;483;439;86;47;258;262;68;277;;74;;463;92;194;922;133;520
04.09.2023 09:00;245;255;52;31;121;90;50;103;;31;;191;59;111;500;83;211
04.09.2023 10:00;171;212;56;32;68;82;57;121;;47;;177;91;138;383;88;150
04.09.2023 11:00;173;267;85;21;80;64;84;187;;37;;172;145;174;440;106;144
04.09.2023 12:00;196;291;71;47;90;87;102;173;;55;;262;165;178;487;118;177
04.09.2023 13:00;199;440;95;63;139;95;108;178;;65;;251;146;235;639;158;234
04.09.2023 14:00;230;412;97;47;152;140;104;218;;82;;260;166;252;642;144;292
04.09.2023 15:00;279;495;152;70;213;189;106;254;;92;;371;179;304;774;222;402
04.09.2023 16:00;397;695;181;108;262;197;127;315;;109;;399;239;333;1092;289;459
04.09.2023 17:00;371;769;158;65;313;228;118;344;;117;;511;245;433;1140;223;541
04.09.2023 18:00;373;668;147;82;216;188;121;282;;109;;416;185;438;1041;229;404
04.09.2023 19:00;311;484;107;54;163;166;77;214;;108;;267;135;422;795;161;329
04.09.2023 20:00;232;307;70;47;100;78;37;119;;65;;164;93;231;539;117;178
04.09.2023 21:00;135;186;32;19;51;47;5;46;;23;;88;28;93;321;51;98
04.09.2023 22:00;91;185;15;4;47;19;2;16;;17;;45;7;57;276;19;66
04.09.2023 23:00;39;53;5;6;13;12;4;3;;2;;8;2;7;92;11;25
05.09.2023 00:00;11;18;3;2;0;3;2;4;;2;;3;0;5;29;5;3
05.09.2023 01:00;5;8;0;1;1;0;1;0;;0;;0;0;1;13;1;1
05.09.2023 02:00;1;12;3;0;1;1;0;0;;0;;3;1;0;13;3;2
05.09.2023 03:00;2;6;2;1;4;1;1;0;;0;;2;1;0;8;3;5
05.09.2023 04:00;9;12;5;3;7;3;3;4;;0;;4;3;2;21;8;10
05.09.2023 05:00;51;45;18;13;29;10;6;13;;5;;23;8;16;96;31;39
05.09.2023 06:00;183;177;77;65;95;55;30;57;;12;;92;47;60;360;142;150
05.09.2023 07:00;553;469;127;104;255;261;96;226;;81;;356;108;285;1022;231;516
05.09.2023 08:00;562;482;111;59;363;306;96;313;;76;;542;126;274;1044;170;669
05.09.2023 09:00;301;362;93;44;137;137;51;138;;45;;292;76;151;663;137;274
05.09.2023 10:00;191;266;83;41;82;78;82;153;;47;;186;120;166;457;124;160
05.09.2023 11:00;195;309;56;35;112;65;78;195;;60;;209;171;188;504;91;177
05.09.2023 12:00;240;374;76;34;129;92;94;226;;69;;247;152;218;614;110;221
05.09.2023 13:00;215;491;111;43;138;114;109;266;;73;;305;174;224;706;154;252
05.09.2023 14:00;242;478;102;56;182;135;110;211;;94;;351;199;257;720;158;317
05.09.2023 15:00;327;583;130;49;224;170;97;264;;99;;347;193;304;910;179;394
05.09.2023 16:00;388;687;199;115;318;233;149;331;;130;;445;220;367;1075;314;551
05.09.2023 17:00;366;803;192;105;359;298;170;382;;138;;610;244;418;1169;297;657
05.09.2023 18:00;417;756;165;77;259;216;115;303;;141;;460;214;471;1173;242;475
05.09.2023 19:00;339;553;107;78;151;160;112;277;;91;;298;160;347;892;185;311
05.09.2023 20:00;252;398;88;58;124;106;35;176;;67;;208;112;286;650;146;230
05.09.2023 21:00;184;238;50;16;74;30;17;62;;35;;95;53;120;422;66;104
05.09.2023 22:00;131;192;25;9;54;29;12;35;;48;;67;17;51;323;34;83
05.09.2023 23:00;35;74;5;1;11;10;4;10;;4;;17;5;18;109;6;21
06.09.2023 00:00;17;27;4;1;6;1;7;5;;2;;11;1;2;44;5;7
06.09.2023 01:00;5;14;1;0;3;3;3;0;;0;;2;0;4;19;1;6
06.09.2023 02:00;6;5;1;1;1;2;1;0;;0;;2;0;1;11;2;3
06.09.2023 03:00;3;4;5;0;3;1;0;2;;0;;1;0;0;7;5;4
06.09.2023 04:00;6;9;9;1;9;4;1;3;;0;;1;4;2;15;10;13
06.09.2023 05:00;47;61;19;10;31;16;7;16;;2;;25;9;12;108;29;47
06.09.2023 06:00;167;162;72;52;109;60;38;64;;13;;94;43;82;329;124;169
06.09.2023 07:00;549;465;136;108;263;231;94;210;;99;;358;126;299;1014;244;494
06.09.2023 08:00;537;505;115;74;310;295;75;263;;69;;532;101;255;1042;189;605
06.09.2023 09:00;279;321;56;48;162;135;61;154;;50;;265;83;158;600;104;297
06.09.2023 10:00;221;281;48;37;129;77;88;204;;58;;220;172;188;502;85;206
06.09.2023 11:00;193;279;75;37;79;92;106;203;;41;;217;169;188;472;112;171
06.09.2023 12:00;238;395;72;47;104;107;99;176;;58;;293;146;224;633;119;211
06.09.2023 13:00;205;461;97;43;143;106;92;221;;102;;276;162;247;666;140;249
06.09.2023 14:00;210;518;91;74;162;142;96;234;;84;;276;173;271;728;165;304
06.09.2023 15:00;297;540;148;64;230;166;115;310;;87;;354;182;273;837;212;396
06.09.2023 16:00;323;655;209;97;290;207;126;352;;92;;457;252;387;978;306;497
06.09.2023 17:00;399;754;159;122;353;232;144;357;;129;;543;220;453;1153;281;585
06.09.2023 18:00;401;756;176;89;288;225;129;365;;118;;473;249;466;1157;265;513
06.09.2023 19:00;350;520;133;65;182;187;79;253;;96;;356;199;389;870;198;369
06.09.2023 20:00;284;370;63;50;176;97;43;137;;93;;196;104;274;654;113;273
06.09.2023 21:00;210;270;39;22;72;53;18;45;;42;;102;48;139;480;61;125
06.09.2023 22:00;153;187;22;12;53;38;7;25;;22;;81;15;61;340;34;91
06.09.2023 23:00;74;98;9;4;14;12;1;15;;10;;27;7;21;172;13;26
07.09.2023 00:00;12;28;6;1;3;4;0;1;;2;;6;0;5;40;7;7
07.09.2023 01:00;10;11;6;0;4;1;0;1;;0;;5;1;3;21;6;5
07.09.2023 02:00;2;5;0;0;1;1;1;0;;0;;2;0;0;7;0;2
07.09.2023 03:00;0;4;2;0;6;1;0;0;;0;;0;0;0;4;2;7
07.09.2023 04:00;7;12;3;1;3;3;0;0;;0;;4;2;2;19;4;6
07.09.2023 05:00;50;45;21;10;35;19;5;11;;2;;15;4;15;95;31;54
07.09.2023 06:00;166;145;65;53;85;38;32;46;;16;;84;35;60;311;118;123
07.09.2023 07:00;534;436;120;114;237;229;92;203;;84;;335;103;262;970;234;466
07.09.2023 08:00;496;485;95;57;304;275;94;280;;79;;488;116;253;981;152;579
07.09.2023 09:00;275;330;76;36;133;110;65;151;;74;;260;97;152;605;112;243
07.09.2023 10:00;224;260;60;45;105;76;79;176;;54;;200;110;151;484;105;181
07.09.2023 11:00;193;301;68;47;88;84;104;190;;47;;231;149;175;494;115;172
07.09.2023 12:00;235;382;59;46;114;95;83;180;;64;;237;169;177;617;105;209
07.09.2023 13:00;221;450;80;56;136;95;87;190;;59;;253;161;224;671;136;231
07.09.2023 14:00;257;448;83;52;173;104;100;219;;68;;255;158;233;705;135;277
07.09.2023 15:00;276;542;146;62;200;143;136;282;;83;;338;167;262;818;208;343
07.09.2023 16:00;381;700;172;102;237;184;150;313;;114;;397;212;349;1081;274;421
07.09.2023 17:00;375;716;164;102;316;231;140;325;;112;;508;201;417;1091;266;547
07.09.2023 18:00;386;701;156;98;238;196;122;285;;108;;415;196;419;1087;254;434
07.09.2023 19:00;299;535;116;72;162;159;103;255;;92;;346;152;341;834;188;321
07.09.2023 20:00;283;350;78;46;129;106;49;136;;82;;190;126;230;633;124;235
07.09.2023 21:00;227;265;31;19;73;49;11;68;;30;;114;36;124;492;50;122
07.09.2023 22:00;162;191;25;7;63;35;18;38;;21;;71;12;82;353;32;98
07.09.2023 23:00;48;103;11;7;26;16;6;11;;10;;40;2;20;151;18;42
08.09.2023 00:00;19;45;5;2;16;5;3;5;;2;;6;0;6;64;7;21
08.09.2023 01:00;9;11;6;5;2;0;2;0;;1;;4;0;4;20;11;2
08.09.2023 02:00;5;5;4;1;1;1;3;1;;0;;1;0;1;10;5;2
08.09.2023 03:00;1;8;3;0;5;0;0;0;;0;;0;0;1;9;3;5
08.09.2023 04:00;7;6;7;3;3;3;1;3;;1;;4;4;2;13;10;6
08.09.2023 05:00;50;38;20;11;20;12;10;10;;2;;20;7;13;88;31;32
08.09.2023 06:00;131;138;58;34;80;41;27;40;;9;;59;39;49;269;92;121
08.09.2023 07:00;368;361;105;93;173;155;60;150;;76;;244;86;248;729;198;328
08.09.2023 08:00;406;390;74;42;188;176;48;214;;55;;354;101;177;796;116;364
08.09.2023 09:00;248;335;59;35;107;94;71;129;;49;;217;83;129;583;94;201
08.09.2023 10:00;192;293;57;33;67;59;110;143;;36;;197;113;142;485;90;126
08.09.2023 11:00;210;333;82;38;81;85;75;161;;56;;175;161;181;543;120;166
08.09.2023 12:00;212;421;91;47;114;72;89;170;;73;;208;124;185;633;138;186
08.09.2023 13:00;274;526;116;56;146;102;107;214;;92;;256;167;257;800;172;248
08.09.2023 14:00;288;489;119;59;164;115;93;205;;97;;301;178;212;777;178;279
08.09.2023 15:00;263;512;151;68;187;136;130;293;;78;;347;168;249;775;219;323
08.09.2023 16:00;326;528;113;65;192;113;119;256;;84;;365;191;266;854;178;305
08.09.2023 17:00;296;568;125;62;200;137;123;297;;91;;401;191;280;864;187;337
08.09.2023 18:00;293;617;153;69;184;178;102;222;;113;;332;175;312;910;222;362
08.09.2023 19:00;311;570;109;69;142;137;78;235;;99;;309;146;289;881;178;279
08.09.2023 20:00;223;364;58;36;120;92;50;118;;41;;177;104;206;587;94;212
08.09.2023 21:00;175;226;42;18;71;46;14;59;;54;;88;47;117;401;60;117
08.09.2023 22:00;201;164;32;16;82;33;9;43;;35;;83;30;87;365;48;115
08.09.2023 23:00;157;167;17;9;45;44;7;26;;30;;79;5;67;324;26;89
09.09.2023 00:00;103;105;18;10;40;18;2;14;;34;;25;5;20;208;28;58
09.09.2023 01:00;73;67;12;2;13;16;1;8;;13;;12;0;12;140;14;29
09.09.2023 02:00;30;36;2;0;13;2;2;3;;6;;13;2;4;66;2;15
09.09.2023 03:00;31;9;4;1;6;3;1;5;;10;;9;1;3;40;5;9
09.09.2023 04:00;6;6;4;0;1;3;1;5;;1;;7;1;3;12;4;4
09.09.2023 05:00;10;11;3;1;3;2;0;2;;1;;4;4;3;21;4;5
09.09.2023 06:00;13;22;4;2;10;7;3;8;;0;;12;7;8;35;6;17
09.09.2023 07:00;31;50;18;11;22;13;9;19;;3;;33;13;14;81;29;35
09.09.2023 08:00;78;102;35;21;47;29;28;75;;21;;95;48;64;180;56;76
09.09.2023 09:00;151;184;60;38;83;64;49;130;;35;;117;118;121;335;98;147
09.09.2023 10:00;188;274;78;62;89;73;124;171;;47;;232;152;260;462;140;162
09.09.2023 11:00;228;363;91;76;127;96;154;283;;80;;288;280;253;591;167;223
09.09.2023 12:00;237;416;124;61;119;92;120;258;;105;;284;240;261;653;185;211
09.09.2023 13:00;254;405;108;82;139;117;126;240;;96;;317;231;281;659;190;256
09.09.2023 14:00;259;446;111;64;111;101;129;256;;104;;304;233;267;705;175;212
09.09.2023 15:00;232;438;138;67;139;120;128;304;;75;;311;275;294;670;205;259
09.09.2023 16:00;211;403;143;79;161;95;118;252;;97;;347;248;258;614;222;256
09.09.2023 17:00;267;426;113;69;148;121;124;303;;96;;335;253;335;693;182;269
09.09.2023 18:00;275;465;98;69;160;131;114;283;;69;;287;219;329;740;167;291
09.09.2023 19:00;308;419;104;61;134;127;80;204;;73;;302;183;252;727;165;261
09.09.2023 20:00;228;267;55;48;105;93;40;144;;60;;207;126;193;495;103;198
09.09.2023 21:00;128;207;37;21;59;55;15;67;;39;;84;48;97;335;58;114
09.09.2023 22:00;147;155;42;20;65;38;6;31;;30;;78;40;94;302;62;103
09.09.2023 23:00;106;134;14;6;54;29;11;26;;11;;54;13;46;240;20;83
10.09.2023 00:00;100;94;27;4;27;16;7;10;;14;;48;5;25;194;31;43
10.09.2023 01:00;55;67;14;7;17;9;8;13;;17;;29;3;11;122;21;26
10.09.2023 02:00;34;37;8;5;9;6;1;3;;6;;22;3;5;71;13;15
10.09.2023 03:00;23;29;0;1;7;1;3;0;;2;;9;2;9;52;1;8
10.09.2023 04:00;6;10;2;1;1;5;3;6;;1;;5;1;1;16;3;6
10.09.2023 05:00;9;13;7;1;2;7;2;2;;1;;4;0;2;22;8;9
10.09.2023 06:00;20;17;5;3;3;7;6;11;;1;;10;13;7;37;8;10
10.09.2023 07:00;20;33;19;15;16;14;16;25;;4;;43;18;30;53;34;30
10.09.2023 08:00;48;64;35;19;45;34;40;88;;18;;81;68;68;112;54;79
10.09.2023 09:00;109;203;84;38;115;82;101;195;;46;;249;127;181;312;122;197
10.09.2023 10:00;212;324;110;82;187;196;156;321;;105;;437;279;308;536;192;383
10.09.2023 11:00;197;299;170;74;167;203;212;384;;96;;425;293;343;496;244;370
10.09.2023 12:00;245;316;161;76;192;234;175;429;;111;;508;301;321;561;237;426
10.09.2023 13:00;222;401;178;103;186;166;190;334;;98;;415;272;324;623;281;352
10.09.2023 14:00;248;388;150;86;219;179;190;368;;112;;447;263;318;636;236;398
10.09.2023 15:00;240;355;177;107;198;114;139;279;;72;;357;236;301;595;284;312
10.09.2023 16:00;194;359;131;82;195;112;149;307;;75;;330;246;304;553;213;307
10.09.2023 17:00;344;432;157;69;211;121;156;340;;123;;383;246;322;776;226;332
10.09.2023 18:00;294;367;116;110;157;134;132;249;;88;;327;207;301;661;226;291
10.09.2023 19:00;292;310;97;88;148;100;96;237;;102;;264;180;275;602;185;248
10.09.2023 20:00;251;249;55;45;106;76;58;145;;93;;147;117;181;500;100;182
10.09.2023 21:00;162;146;32;26;43;20;15;33;;50;;50;31;79;308;58;63
10.09.2023 22:00;108;84;22;12;24;16;2;14;;26;;23;11;25;192;34;40
10.09.2023 23:00;72;44;5;3;17;5;4;7;;11;;12;4;8;116;8;22
11.09.2023 00:00;27;22;2;1;14;0;3;2;;5;;6;0;4;49;3;14
11.09.2023 01:00;8;18;5;0;1;4;1;1;;2;;1;1;1;26;5;5
11.09.2023 02:00;4;4;2;1;3;1;1;0;;1;;2;0;1;8;3;4
11.09.2023 03:00;3;7;2;1;3;1;1;1;;0;;1;7;0;10;3;4
11.09.2023 04:00;5;10;3;2;3;4;2;0;;1;;3;2;2;15;5;7
11.09.2023 05:00;52;39;17;13;20;17;4;8;;1;;12;7;15;91;30;37
11.09.2023 06:00;181;150;52;63;85;41;30;51;;16;;75;39;54;331;115;126
11.09.2023 07:00;487;419;130;112;215;224;114;193;;81;;335;102;268;906;242;439
11.09.2023 08:00;456;439;100;50;300;255;74;276;;81;;449;90;214;895;150;555
11.09.2023 09:00;248;289;55;37;120;118;57;141;;62;;254;92;190;537;92;238
11.09.2023 10:00;196;259;62;39;99;67;61;111;;26;;187;106;157;455;101;166
11.09.2023 11:00;170;322;73;51;76;82;78;146;;56;;176;130;166;492;124;158
11.09.2023 12:00;192;331;69;34;88;91;83;179;;68;;201;153;183;523;103;179
11.09.2023 13:00;205;430;113;43;133;102;96;147;;88;;235;118;278;635;156;235
11.09.2023 14:00;192;434;79;49;116;98;72;168;;80;;257;132;174;626;128;214
11.09.2023 15:00;249;499;115;54;186;129;76;214;;99;;268;142;207;748;169;315
11.09.2023 16:00;313;662;167;81;281;177;102;238;;121;;385;181;270;975;248;458
11.09.2023 17:00;336;716;185;82;266;217;115;298;;148;;461;220;311;1052;267;483
11.09.2023 18:00;328;673;156;70;220;195;107;258;;103;;426;175;352;1001;226;415
11.09.2023 19:00;300;440;88;79;132;153;61;213;;94;;283;146;306;740;167;285
11.09.2023 20:00;215;313;58;26;84;92;27;132;;49;;163;94;180;528;84;176
11.09.2023 21:00;176;196;20;23;58;28;6;44;;39;;74;31;78;372;43;86
11.09.2023 22:00;163;153;19;18;43;30;8;18;;34;;40;10;41;316;37;73
11.09.2023 23:00;84;54;3;5;20;10;1;6;;20;;17;3;13;138;8;30
12.09.2023 00:00;19;30;6;1;5;4;0;0;;7;;5;1;3;49;7;9
12.09.2023 01:00;15;9;2;2;4;2;0;0;;7;;2;0;1;24;4;6
12.09.2023 02:00;4;10;2;0;2;1;1;0;;3;;6;0;2;14;2;3
12.09.2023 03:00;6;2;0;0;3;3;0;4;;0;;0;2;0;8;0;6
12.09.2023 04:00;4;9;1;1;4;6;1;0;;1;;1;2;1;13;2;10
12.09.2023 05:00;45;44;18;13;23;13;4;11;;5;;26;4;11;89;31;36
12.09.2023 06:00;137;143;50;38;75;51;25;39;;8;;66;37;45;280;88;126
12.09.2023 07:00;423;409;107;89;228;191;71;166;;59;;313;81;194;832;196;419
12.09.2023 08:00;466;464;108;46;260;263;59;225;;58;;428;87;221;930;154;523
12.09.2023 09:00;255;280;60;22;132;107;39;105;;38;;185;66;121;535;82;239
12.09.2023 10:00;177;283;47;25;78;58;35;123;;52;;137;93;108;460;72;136
12.09.2023 11:00;182;259;51;18;72;66;44;139;;44;;170;90;119;441;69;138
12.09.2023 12:00;205;282;71;23;93;69;47;131;;49;;169;96;145;487;94;162
12.09.2023 13:00;189;401;77;37;114;102;57;137;;82;;211;101;137;590;114;216
12.09.2023 14:00;194;443;77;38;130;93;57;156;;55;;215;126;164;637;115;223
12.09.2023 15:00;268;457;83;53;189;124;75;169;;69;;260;123;217;725;136;313
12.09.2023 16:00;283;566;114;52;207;166;78;194;;80;;250;139;208;849;166;373
12.09.2023 17:00;278;587;99;49;195;186;59;158;;88;;347;106;235;865;148;381
12.09.2023 18:00;235;537;68;51;149;146;53;142;;76;;260;89;191;772;119;295
12.09.2023 19:00;144;242;21;17;45;38;14;56;;52;;73;39;80;386;38;83
12.09.2023 20:00;80;134;12;6;18;8;11;17;;18;;29;7;24;214;18;26
12.09.2023 21:00;104;98;12;3;31;5;2;13;;17;;13;10;24;202;15;36
12.09.2023 22:00;57;81;5;6;25;9;0;6;;6;;13;4;11;138;11;34
12.09.2023 23:00;22;37;3;0;10;4;0;2;;1;;4;1;9;59;3;14
13.09.2023 00:00;11;12;2;1;3;1;1;1;;2;;2;0;2;23;3;4
13.09.2023 01:00;3;8;1;0;2;1;2;1;;0;;1;1;0;11;1;3
13.09.2023 02:00;2;3;1;0;1;0;0;0;;0;;0;0;0;5;1;1
13.09.2023 03:00;2;4;2;3;3;0;1;0;;1;;1;0;0;6;5;3
13.09.2023 04:00;1;6;4;1;0;4;3;0;;0;;0;1;1;7;5;4
13.09.2023 05:00;40;35;16;6;19;11;5;6;;0;;12;3;12;75;22;30
13.09.2023 06:00;129;121;30;39;57;31;24;38;;10;;52;27;37;250;69;88
13.09.2023 07:00;412;377;84;93;199;185;64;154;;86;;259;89;203;789;177;384
13.09.2023 08:00;465;432;75;50;226;233;62;223;;52;;386;82;183;897;125;459
13.09.2023 09:00;196;259;36;22;100;97;37;101;;45;;179;66;91;455;58;197
13.09.2023 10:00;172;195;24;14;43;56;48;81;;38;;101;56;83;367;38;99
13.09.2023 11:00;147;219;39;17;62;67;27;97;;30;;116;83;85;366;56;129
13.09.2023 12:00;171;251;26;15;75;62;39;88;;40;;145;70;100;422;41;137
13.09.2023 13:00;151;371;49;19;120;89;49;125;;54;;165;84;134;522;68;209
13.09.2023 14:00;192;363;66;30;115;91;43;134;;51;;196;86;152;555;96;206
13.09.2023 15:00;260;460;71;33;121;126;44;134;;70;;202;97;147;720;104;247
13.09.2023 16:00;271;509;86;42;167;127;67;178;;63;;283;97;150;780;128;294
13.09.2023 17:00;291;624;106;53;195;178;69;209;;61;;343;125;232;915;159;373
13.09.2023 18:00;219;443;72;38;145;104;64;141;;65;;233;83;184;662;110;249
13.09.2023 19:00;189;366;58;17;89;105;28;118;;40;;188;63;148;555;75;194
13.09.2023 20:00;134;271;37;20;57;40;6;49;;29;;91;28;78;405;57;97
13.09.2023 21:00;122;155;17;4;28;23;2;18;;13;;71;17;46;277;21;51
13.09.2023 22:00;78;146;19;10;36;12;4;13;;8;;41;10;24;224;29;48
13.09.2023 23:00;33;67;6;1;13;9;0;6;;6;;15;1;13;100;7;22
14.09.2023 00:00;10;16;1;3;4;3;0;1;;1;;1;0;3;26;4;7
14.09.2023 01:00;5;14;0;0;0;1;1;3;;0;;3;2;1;19;0;1
14.09.2023 02:00;5;11;1;0;1;0;0;0;;0;;4;0;0;16;1;1
14.09.2023 03:00;1;6;4;1;4;1;2;2;;0;;3;0;0;7;5;5
14.09.2023 04:00;2;13;8;1;6;3;1;2;;0;;2;2;2;15;9;9
14.09.2023 05:00;38;38;19;12;21;11;6;5;;2;;9;9;8;76;31;32
14.09.2023 06:00;138;133;55;57;61;47;20;33;;12;;65;27;51;271;112;108
14.09.2023 07:00;493;399;89;97;193;236;72;166;;86;;305;81;224;892;186;429
14.09.2023 08:00;507;463;83;47;276;256;57;233;;59;;416;92;206;970;130;532
14.09.2023 09:00;254;271;49;25;127;128;58;120;;37;;224;66;113;525;74;255
14.09.2023 10:00;169;195;33;28;72;68;50;115;;30;;127;72;88;364;61;140
14.09.2023 11:00;145;228;53;26;57;44;59;111;;41;;152;76;111;373;79;101
14.09.2023 12:00;182;308;54;25;93;89;59;143;;37;;176;105;134;490;79;182
14.09.2023 13:00;201;416;69;35;99;92;65;160;;61;;211;127;172;617;104;191
14.09.2023 14:00;217;383;58;44;152;105;60;174;;61;;222;130;192;600;102;257
14.09.2023 15:00;288;501;103;52;184;158;84;225;;89;;319;142;260;789;155;342
14.09.2023 16:00;337;650;159;63;242;162;100;236;;97;;374;176;320;987;222;404
14.09.2023 17:00;358;760;145;68;242;196;92;275;;127;;427;170;365;1118;213;438
14.09.2023 18:00;292;654;105;68;215;173;71;245;;110;;331;137;277;946;173;388
14.09.2023 19:00;300;485;66;47;156;122;45;134;;74;;265;94;276;785;113;278
14.09.2023 20:00;158;300;47;22;84;75;31;69;;42;;121;58;109;458;69;159
14.09.2023 21:00;119;212;14;10;60;29;12;16;;17;;73;24;69;331;24;89
14.09.2023 22:00;76;198;12;9;29;30;5;22;;13;;44;9;22;274;21;59
14.09.2023 23:00;37;82;8;1;12;8;1;2;;5;;25;5;12;119;9;20
15.09.2023 00:00;12;39;2;0;7;10;2;3;;0;;22;1;3;51;2;17
15.09.2023 01:00;11;9;1;2;2;1;0;1;;1;;3;0;0;20;3;3
15.09.2023 02:00;1;9;1;0;1;0;1;1;;0;;0;1;0;10;1;1
15.09.2023 03:00;4;4;2;2;3;1;2;1;;0;;1;0;0;8;4;4
15.09.2023 04:00;0;13;3;2;6;5;1;2;;0;;4;1;2;13;5;11
15.09.2023 05:00;38;51;17;8;16;7;5;7;;2;;13;7;8;89;25;23
15.09.2023 06:00;114;134;47;39;61;30;26;25;;11;;56;27;41;248;86;91
15.09.2023 07:00;350;364;86;102;146;155;61;127;;87;;205;76;197;714;188;301
15.09.2023 08:00;358;334;52;43;178;184;43;183;;55;;290;69;156;692;95;362
15.09.2023 09:00;235;267;33;30;89;87;49;92;;39;;178;74;104;502;63;176
15.09.2023 10:00;187;258;52;27;82;59;52;127;;42;;150;98;114;445;79;141
15.09.2023 11:00;221;292;44;30;93;64;54;163;;42;;195;140;207;513;74;157
15.09.2023 12:00;301;415;86;52;98;91;92;213;;58;;274;167;201;716;138;189
15.09.2023 13:00;307;545;119;37;130;121;111;219;;69;;320;171;264;852;156;251
15.09.2023 14:00;267;594;106;59;171;132;108;243;;99;;385;219;284;861;165;303
15.09.2023 15:00;294;597;139;72;183;130;125;327;;74;;412;237;307;891;211;313
15.09.2023 16:00;304;637;122;58;210;173;121;271;;81;;405;199;327;941;180;383
15.09.2023 17:00;335;568;107;79;192;171;113;255;;89;;390;180;374;903;186;363
15.09.2023 18:00;312;543;110;54;199;164;111;256;;114;;383;133;387;855;164;363
15.09.2023 19:00;268;422;80;40;119;92;57;163;;85;;209;102;246;690;120;211
15.09.2023 20:00;188;268;38;17;54;67;15;74;;50;;107;43;132;456;55;121
15.09.2023 21:00;129;196;15;10;40;26;15;41;;32;;58;23;71;325;25;66
15.09.2023 22:00;145;178;20;8;52;24;2;30;;24;;54;15;79;323;28;76
15.09.2023 23:00;76;130;16;4;36;19;2;24;;16;;33;14;32;206;20;55
16.09.2023 00:00;35;93;4;4;21;8;1;4;;7;;43;0;15;128;8;29
16.09.2023 01:00;20;37;5;1;11;1;0;8;;2;;10;0;6;57;6;12
16.09.2023 02:00;12;37;4;3;1;2;0;5;;3;;1;1;3;49;7;3
16.09.2023 03:00;2;17;1;0;2;2;0;3;;3;;1;1;2;19;1;4
16.09.2023 04:00;7;10;4;1;2;1;2;0;;1;;1;1;0;17;5;3
16.09.2023 05:00;8;13;3;2;4;3;2;1;;1;;4;0;6;21;5;7
16.09.2023 06:00;17;28;5;6;26;12;2;9;;1;;20;4;9;45;11;38
16.09.2023 07:00;40;52;21;9;29;26;5;22;;16;;53;16;45;92;30;55
16.09.2023 08:00;113;126;27;26;72;74;30;59;;49;;136;36;121;239;53;146
16.09.2023 09:00;177;215;51;40;96;95;51;131;;53;;191;79;140;392;91;191
16.09.2023 10:00;201;301;65;34;127;140;93;223;;61;;314;169;201;502;99;267
16.09.2023 11:00;230;382;95;43;159;185;124;298;;84;;452;264;296;612;138;344
16.09.2023 12:00;222;419;89;49;225;173;149;314;;101;;441;204;394;641;138;398
16.09.2023 13:00;284;444;114;65;247;158;197;386;;83;;534;272;345;728;179;405
16.09.2023 14:00;287;516;137;71;229;182;160;343;;102;;545;253;388;803;208;411
16.09.2023 15:00;297;497;106;61;226;174;212;363;;68;;463;295;357;794;167;400
16.09.2023 16:00;332;444;110;69;200;194;138;316;;91;;450;268;369;776;179;394
16.09.2023 17:00;296;446;96;70;162;131;112;251;;97;;308;231;336;742;166;293
16.09.2023 18:00;248;450;82;77;169;133;109;224;;75;;284;176;324;698;159;302
16.09.2023 19:00;220;307;56;27;76;66;46;107;;65;;153;100;175;527;83;142
16.09.2023 20:00;112;237;31;14;56;38;14;64;;46;;91;49;87;349;45;94
16.09.2023 21:00;122;136;10;7;24;57;4;24;;14;;51;20;70;258;17;81
16.09.2023 22:00;80;145;6;3;39;28;5;17;;21;;42;14;37;225;9;67
16.09.2023 23:00;58;130;9;3;25;14;0;14;;11;;26;3;25;188;12;39
17.09.2023 00:00;52;110;12;4;26;6;4;10;;5;;18;2;25;162;16;32
17.09.2023 01:00;37;57;6;2;8;6;0;12;;1;;13;8;11;94;8;14
17.09.2023 02:00;12;32;9;1;3;11;3;1;;4;;5;0;17;44;10;14
17.09.2023 03:00;7;18;1;0;0;2;0;2;;0;;5;4;3;25;1;2
17.09.2023 04:00;4;11;1;2;1;1;0;2;;1;;1;1;0;15;3;2
17.09.2023 05:00;5;13;4;0;1;1;2;2;;1;;1;1;2;18;4;2
17.09.2023 06:00;9;9;11;8;4;4;2;4;;0;;12;6;6;18;19;8
17.09.2023 07:00;15;39;9;4;8;15;6;17;;1;;27;13;21;54;13;23
17.09.2023 08:00;46;72;26;12;37;27;24;57;;8;;55;48;52;118;38;64
17.09.2023 09:00;94;148;45;35;78;72;52;125;;37;;136;121;122;242;80;150
17.09.2023 10:00;177;207;119;58;98;123;86;237;;82;;277;162;244;384;177;221
17.09.2023 11:00;130;259;152;79;165;136;168;297;;75;;318;271;345;389;231;301
17.09.2023 12:00;192;292;136;108;180;163;226;457;;79;;397;369;403;484;244;343
17.09.2023 13:00;269;361;189;134;174;166;256;408;;137;;445;343;479;630;323;340
17.09.2023 14:00;301;383;189;75;260;194;220;424;;112;;476;372;503;684;264;454
17.09.2023 15:00;276;411;154;136;249;169;241;463;;133;;487;351;555;687;290;418
17.09.2023 16:00;337;381;119;80;259;178;187;427;;111;;490;312;487;718;199;437
17.09.2023 17:00;320;427;139;66;246;175;132;367;;130;;422;294;421;747;205;421
17.09.2023 18:00;284;337;123;54;169;141;123;275;;102;;371;197;394;621;177;310
17.09.2023 19:00;232;276;66;59;131;95;66;213;;63;;193;129;267;508;125;226
17.09.2023 20:00;148;178;29;23;51;70;20;99;;49;;119;76;121;326;52;121
17.09.2023 21:00;91;107;16;9;59;24;22;47;;10;;63;34;47;198;25;83
17.09.2023 22:00;56;77;8;9;27;15;1;11;;11;;23;5;37;133;17;42
17.09.2023 23:00;27;34;2;4;5;7;1;7;;4;;10;4;8;61;6;12
18.09.2023 00:00;13;13;4;1;1;3;1;2;;1;;2;0;3;26;5;4
18.09.2023 01:00;9;9;0;0;2;0;0;0;;0;;5;1;2;18;0;2
18.09.2023 02:00;4;2;0;0;3;1;0;0;;0;;0;0;1;6;0;4
18.09.2023 03:00;1;3;0;0;4;1;0;0;;0;;0;0;0;4;0;5
18.09.2023 04:00;3;6;2;1;3;1;2;1;;4;;5;4;3;9;3;4
18.09.2023 05:00;37;33;14;11;25;13;4;10;;2;;16;5;12;70;25;38
18.09.2023 06:00;143;127;46;33;66;39;23;26;;11;;63;19;53;270;79;105
18.09.2023 07:00;415;388;84;74;199;171;69;135;;73;;227;76;203;803;158;370
18.09.2023 08:00;450;421;84;51;230;224;52;185;;60;;387;84;172;871;135;454
18.09.2023 09:00;233;257;41;16;105;87;31;82;;39;;191;46;97;490;57;192
18.09.2023 10:00;180;239;40;19;56;48;38;79;;41;;104;58;91;419;59;104
18.09.2023 11:00;167;237;40;26;77;57;21;104;;36;;134;102;112;404;66;134
18.09.2023 12:00;187;295;40;16;67;56;31;129;;48;;157;71;103;482;56;123
18.09.2023 13:00;193;412;70;25;77;83;59;120;;60;;194;91;175;605;95;160
18.09.2023 14:00;218;373;65;35;122;80;54;132;;56;;188;87;136;591;100;202
18.09.2023 15:00;229;471;72;48;166;139;72;186;;84;;261;115;217;700;120;305
18.09.2023 16:00;310;604;109;74;210;164;86;192;;89;;299;144;273;914;183;374
18.09.2023 17:00;362;701;120;73;242;182;94;257;;100;;408;178;315;1063;193;424
18.09.2023 18:00;304;553;98;46;195;135;74;233;;93;;362;148;266;857;144;330
18.09.2023 19:00;253;389;69;26;110;109;50;153;;74;;200;93;204;642;95;219
18.09.2023 20:00;122;242;29;14;47;30;21;43;;30;;90;30;66;364;43;77
18.09.2023 21:00;93;176;17;8;30;19;9;10;;11;;36;10;26;269;25;49
18.09.2023 22:00;61;120;7;3;23;11;3;11;;7;;20;3;15;181;10;34
18.09.2023 23:00;32;54;4;4;12;9;3;7;;5;;6;1;8;86;8;21
19.09.2023 00:00;6;18;1;0;1;2;0;0;;0;;1;0;1;24;1;3
19.09.2023 01:00;5;4;1;0;0;2;0;2;;0;;0;0;1;9;1;2
19.09.2023 02:00;1;4;0;1;1;0;0;0;;0;;0;0;0;5;1;1
19.09.2023 03:00;2;4;0;0;5;2;1;1;;0;;1;1;0;6;0;7
19.09.2023 04:00;2;8;5;1;0;2;0;2;;0;;3;2;1;10;6;2
19.09.2023 05:00;49;42;16;14;24;10;5;8;;2;;15;4;13;91;30;34
19.09.2023 06:00;155;131;64;37;79;47;32;37;;8;;62;33;62;286;101;126
19.09.2023 07:00;511;404;94;98;216;202;72;190;;66;;324;87;213;915;192;418
19.09.2023 08:00;537;472;101;66;315;276;77;240;;69;;446;92;266;1009;167;591
19.09.2023 09:00;234;285;75;18;124;91;36;111;;33;;234;58;105;519;93;215
19.09.2023 10:00;154;216;40;29;66;65;31;121;;28;;149;128;92;370;69;131
19.09.2023 11:00;153;261;45;29;92;67;57;112;;21;;136;88;107;414;74;159
19.09.2023 12:00;185;301;44;34;98;83;45;114;;38;;154;73;112;486;78;181
19.09.2023 13:00;225;407;74;24;112;79;62;140;;57;;172;110;134;632;98;191
19.09.2023 14:00;226;390;75;42;153;110;65;147;;51;;213;91;216;616;117;263
19.09.2023 15:00;272;543;89;47;173;162;69;188;;70;;316;116;241;815;136;335
19.09.2023 16:00;352;640;152;77;239;183;107;269;;86;;356;153;249;992;229;422
19.09.2023 17:00;370;676;121;92;290;219;94;230;;126;;442;189;329;1046;213;509
19.09.2023 18:00;316;629;109;62;191;144;92;205;;64;;354;151;262;945;171;335
19.09.2023 19:00;246;413;70;39;99;103;46;140;;58;;209;89;201;659;109;202
19.09.2023 20:00;134;251;29;22;61;36;20;58;;36;;76;41;71;385;51;97
19.09.2023 21:00;113;223;18;7;41;19;4;25;;19;;47;21;32;336;25;60
19.09.2023 22:00;86;149;13;1;31;12;4;10;;8;;24;4;24;235;14;43
19.09.2023 23:00;16;69;8;3;21;3;1;8;;6;;9;3;14;85;11;24
20.09.2023 00:00;10;24;4;1;2;5;1;3;;3;;3;0;2;34;5;7
20.09.2023 01:00;7;5;2;1;2;0;0;0;;3;;0;0;0;12;3;2
20.09.2023 02:00;4;8;0;0;1;0;1;0;;0;;1;0;0;12;0;1
20.09.2023 03:00;2;2;3;0;3;1;0;4;;0;;0;0;1;4;3;4
20.09.2023 04:00;6;8;3;1;0;6;2;0;;1;;3;2;3;14;4;6
20.09.2023 05:00;47;48;17;13;31;17;3;5;;2;;20;6;13;95;30;48
20.09.2023 06:00;151;138;50;46;74;47;34;44;;6;;64;42;58;289;96;121
20.09.2023 07:00;463;399;104;120;232;213;78;172;;73;;321;86;236;862;224;445
20.09.2023 08:00;511;463;79;46;289;236;94;226;;71;;451;87;233;974;125;525
20.09.2023 09:00;235;292;42;36;123;101;42;113;;34;;221;65;127;527;78;224
20.09.2023 10:00;168;201;41;20;56;68;73;103;;30;;152;82;110;369;61;124
20.09.2023 11:00;155;240;62;36;77;60;92;154;;28;;170;131;98;395;98;137
20.09.2023 12:00;184;272;50;35;91;58;72;148;;48;;175;132;145;456;85;149
20.09.2023 13:00;216;382;77;30;115;99;83;161;;65;;216;98;180;598;107;214
20.09.2023 14:00;227;433;61;41;146;112;78;174;;60;;227;130;213;660;102;258
20.09.2023 15:00;256;539;111;44;212;151;85;225;;74;;306;173;240;795;155;363
20.09.2023 16:00;372;632;156;69;258;185;115;258;;103;;434;197;311;1004;225;443
20.09.2023 17:00;349;699;147;75;289;234;119;278;;124;;550;207;400;1048;222;523
20.09.2023 18:00;354;598;133;88;204;193;90;231;;113;;391;143;305;952;221;397
20.09.2023 19:00;240;407;66;52;133;119;35;157;;78;;244;113;214;647;118;252
20.09.2023 20:00;181;253;25;23;69;31;18;55;;34;;112;48;112;434;48;100
20.09.2023 21:00;123;195;14;11;59;33;6;26;;20;;86;22;64;318;25;92
20.09.2023 22:00;68;152;13;3;36;15;5;18;;8;;56;10;25;220;16;51
20.09.2023 23:00;45;72;10;6;13;8;2;11;;4;;22;4;12;117;16;21
21.09.2023 00:00;16;24;5;2;4;1;0;2;;2;;3;2;3;40;7;5
21.09.2023 01:00;11;11;0;0;0;0;0;1;;0;;3;2;2;22;0;0
21.09.2023 02:00;5;6;4;1;3;1;2;0;;0;;4;0;0;11;5;4
21.09.2023 03:00;2;4;1;0;4;3;0;0;;0;;2;0;0;6;1;7
21.09.2023 04:00;4;8;2;1;1;4;1;1;;0;;6;3;1;12;3;5
21.09.2023 05:00;38;36;13;11;27;11;5;5;;4;;10;7;9;74;24;38
21.09.2023 06:00;118;134;44;34;67;35;24;34;;6;;59;26;39;252;78;102
21.09.2023 07:00;428;359;89;71;166;177;62;138;;70;;276;65;218;787;160;343
21.09.2023 08:00;447;415;69;45;227;228;48;178;;57;;407;75;181;862;114;455
21.09.2023 09:00;243;309;43;27;141;80;24;106;;33;;173;60;123;552;70;221
21.09.2023 10:00;173;187;37;28;61;66;41;95;;31;;130;70;105;360;65;127
21.09.2023 11:00;160;230;41;16;61;47;32;88;;40;;116;66;110;390;57;108
21.09.2023 12:00;159;314;54;26;83;73;48;83;;25;;158;71;102;473;80;156
21.09.2023 13:00;173;415;35;25;102;73;55;114;;51;;157;71;155;588;60;175
21.09.2023 14:00;164;372;62;30;81;67;33;75;;29;;150;49;109;536;92;148
21.09.2023 15:00;211;395;78;29;106;91;47;107;;41;;199;68;116;606;107;197
21.09.2023 16:00;281;527;105;42;167;132;68;124;;64;;238;60;172;808;147;299
21.09.2023 17:00;150;326;26;14;98;71;21;62;;24;;128;51;79;476;40;169
21.09.2023 18:00;166;373;33;21;112;79;28;71;;38;;129;45;90;539;54;191
21.09.2023 19:00;89;201;25;12;23;26;6;18;;22;;57;12;24;290;37;49
21.09.2023 20:00;64;120;7;5;19;10;0;7;;9;;18;11;20;184;12;29
21.09.2023 21:00;50;85;6;1;17;4;4;6;;0;;18;3;5;135;7;21
21.09.2023 22:00;54;80;8;4;12;4;0;6;;4;;17;6;7;134;12;16
21.09.2023 23:00;23;49;5;0;13;1;2;2;;2;;4;1;2;72;5;14
22.09.2023 00:00;3;18;1;0;4;2;0;0;;2;;1;1;5;21;1;6
22.09.2023 01:00;2;17;2;2;5;0;0;0;;1;;0;0;3;19;4;5
22.09.2023 02:00;0;4;0;0;1;0;0;0;;0;;1;1;0;4;0;1
22.09.2023 03:00;0;2;3;1;4;1;1;0;;0;;0;0;0;2;4;5
22.09.2023 04:00;6;5;6;1;1;2;1;0;;0;;3;1;2;11;7;3
22.09.2023 05:00;34;36;13;10;17;13;5;2;;2;;10;3;7;70;23;30
22.09.2023 06:00;101;105;31;28;50;32;19;21;;5;;35;16;37;206;59;82
22.09.2023 07:00;306;328;52;71;123;124;47;113;;57;;182;58;163;634;123;247
22.09.2023 08:00;346;305;54;25;146;132;31;115;;35;;225;52;140;651;79;278
22.09.2023 09:00;205;247;41;21;103;44;33;70;;24;;147;51;85;452;62;147
22.09.2023 10:00;184;213;34;26;68;54;30;74;;25;;150;54;90;397;60;122
22.09.2023 11:00;166;256;52;21;76;60;58;86;;31;;157;83;116;422;73;136
22.09.2023 12:00;177;318;69;36;77;50;50;102;;29;;160;77;115;495;105;127
22.09.2023 13:00;252;508;64;29;98;76;34;104;;61;;187;88;171;760;93;174
22.09.2023 14:00;195;463;60;51;119;109;72;114;;56;;219;94;177;658;111;228
22.09.2023 15:00;262;432;99;57;135;112;77;163;;63;;259;115;201;694;156;247
22.09.2023 16:00;285;470;81;35;140;109;79;158;;68;;254;115;190;755;116;249
22.09.2023 17:00;173;334;56;28;101;86;54;94;;37;;169;72;117;507;84;187
22.09.2023 18:00;168;295;35;14;56;38;22;55;;37;;92;38;84;463;49;94
22.09.2023 19:00;163;274;39;31;54;50;26;59;;26;;87;26;72;437;70;104
22.09.2023 20:00;100;157;16;7;18;24;6;23;;20;;47;23;36;257;23;42
22.09.2023 21:00;84;128;11;8;21;12;2;10;;7;;28;12;24;212;19;33
22.09.2023 22:00;48;122;5;5;10;10;3;11;;9;;24;3;18;170;10;20
22.09.2023 23:00;35;91;7;2;14;8;0;10;;7;;12;4;3;126;9;22
23.09.2023 00:00;21;55;5;2;7;3;0;0;;5;;9;2;7;76;7;10
23.09.2023 01:00;20;49;6;1;3;0;0;8;;1;;2;0;12;69;7;3
23.09.2023 02:00;13;31;1;0;2;3;4;0;;1;;1;0;0;44;1;5
23.09.2023 03:00;8;22;1;1;4;3;0;3;;1;;2;1;2;30;2;7
23.09.2023 04:00;1;7;1;0;0;1;1;0;;1;;0;0;1;8;1;1
23.09.2023 05:00;11;11;3;1;7;3;0;0;;2;;3;0;4;22;4;10
23.09.2023 06:00;25;17;4;2;7;2;0;1;;0;;5;17;8;42;6;9
23.09.2023 07:00;29;45;14;8;11;19;10;17;;6;;30;10;13;74;22;30
23.09.2023 08:00;67;82;31;15;29;25;16;60;;15;;57;22;39;149;46;54
23.09.2023 09:00;128;145;21;11;48;43;13;49;;25;;66;52;68;273;32;91
23.09.2023 10:00;175;261;50;28;72;74;61;105;;32;;163;102;119;436;78;146
23.09.2023 11:00;176;285;66;62;86;103;97;150;;34;;217;110;204;461;128;189
23.09.2023 12:00;250;311;58;40;93;71;118;211;;64;;251;166;204;561;98;164
23.09.2023 13:00;224;356;62;39;109;87;90;226;;33;;281;166;159;580;101;196
23.09.2023 14:00;200;404;82;33;124;92;113;183;;70;;290;139;191;604;115;216
23.09.2023 15:00;208;391;66;54;114;70;93;207;;55;;246;155;231;599;120;184
23.09.2023 16:00;245;413;67;43;89;113;91;204;;61;;245;149;271;658;110;202
23.09.2023 17:00;239;377;70;36;128;101;78;205;;80;;205;154;264;616;106;229
23.09.2023 18:00;220;335;46;37;96;86;55;127;;64;;222;112;162;555;83;182
23.09.2023 19:00;137;280;31;16;45;51;19;87;;23;;138;59;93;417;47;96
23.09.2023 20:00;78;153;15;8;26;35;3;25;;7;;67;18;33;231;23;61
23.09.2023 21:00;75;118;12;3;29;10;8;17;;17;;31;12;25;193;15;39
23.09.2023 22:00;62;107;8;6;17;16;2;14;;9;;22;16;44;169;14;33
23.09.2023 23:00;57;99;4;4;14;18;0;8;;8;;21;7;21;156;8;32
24.09.2023 00:00;30;74;4;2;3;11;2;5;;1;;8;2;10;104;6;14
24.09.2023 01:00;23;51;2;1;11;6;1;1;;2;;11;4;5;74;3;17
24.09.2023 02:00;18;42;1;3;3;1;2;4;;4;;1;1;1;60;4;4
24.09.2023 03:00;1;10;0;0;2;0;0;1;;0;;4;2;1;11;0;2
24.09.2023 04:00;7;9;1;1;1;1;0;0;;0;;0;2;2;16;2;2
24.09.2023 05:00;5;7;1;0;0;4;4;0;;1;;1;0;1;12;1;4
24.09.2023 06:00;11;7;7;5;5;5;2;3;;1;;6;5;4;18;12;10
24.09.2023 07:00;12;16;3;5;13;2;8;13;;0;;25;7;5;28;8;15
24.09.2023 08:00;25;44;22;7;27;21;9;40;;10;;43;30;43;69;29;48
24.09.2023 09:00;90;110;44;17;64;45;28;92;;32;;97;68;104;200;61;109
24.09.2023 10:00;154;169;64;58;101;53;83;162;;42;;193;152;170;323;122;154
24.09.2023 11:00;157;216;100;59;124;96;134;263;;69;;259;218;262;373;159;220
24.09.2023 12:00;201;289;133;85;174;98;182;327;;85;;367;258;322;490;218;272
24.09.2023 13:00;216;342;145;88;213;164;189;343;;99;;426;296;400;558;233;377
24.09.2023 14:00;277;438;150;97;268;200;249;421;;115;;502;373;531;715;247;468
24.09.2023 15:00;309;389;122;84;293;193;219;386;;123;;451;316;542;698;206;486
24.09.2023 16:00;294;459;150;87;244;196;148;343;;103;;374;295;592;753;237;440
24.09.2023 17:00;356;406;116;112;178;194;145;290;;108;;360;234;554;762;228;372
24.09.2023 18:00;317;318;81;66;160;105;100;188;;83;;220;161;359;635;147;265
24.09.2023 19:00;206;204;52;25;83;73;49;92;;55;;123;75;190;410;77;156
24.09.2023 20:00;110;156;24;17;40;20;10;46;;17;;61;24;70;266;41;60
24.09.2023 21:00;80;78;10;6;18;17;6;12;;8;;21;12;25;158;16;35
24.09.2023 22:00;32;73;6;3;6;3;0;6;;10;;14;3;15;105;9;9
24.09.2023 23:00;24;23;1;0;10;7;0;1;;1;;6;2;7;47;1;17
25.09.2023 00:00;4;10;0;1;0;1;1;0;;0;;1;0;0;14;1;1
25.09.2023 01:00;11;6;0;1;1;1;3;0;;1;;7;0;1;17;1;2
25.09.2023 02:00;4;4;3;0;1;0;0;0;;0;;0;0;0;8;3;1
25.09.2023 03:00;2;3;0;1;2;0;1;0;;0;;2;0;0;5;1;2
25.09.2023 04:00;6;12;1;4;5;6;0;3;;2;;2;2;4;18;5;11
25.09.2023 05:00;49;40;17;15;21;10;5;7;;3;;18;3;10;89;32;31
25.09.2023 06:00;141;145;39;51;76;54;29;35;;12;;56;25;49;286;90;130
25.09.2023 07:00;380;396;87;93;198;187;78;142;;74;;272;78;210;776;180;385
25.09.2023 08:00;409;423;82;39;228;249;52;222;;51;;408;70;197;832;121;477
25.09.2023 09:00;225;266;40;32;93;134;24;92;;32;;191;51;100;491;72;227
25.09.2023 10:00;211;233;45;29;48;71;41;77;;36;;147;62;107;444;74;119
25.09.2023 11:00;167;277;32;19;62;71;44;137;;43;;159;99;137;444;51;133
25.09.2023 12:00;187;339;76;23;82;73;76;143;;43;;191;95;163;526;99;155
25.09.2023 13:00;194;400;82;36;91;81;68;183;;61;;231;140;189;594;118;172
25.09.2023 14:00;241;451;78;40;123;100;67;186;;58;;235;135;213;692;118;223
25.09.2023 15:00;275;493;89;38;193;151;89;214;;91;;297;146;247;768;127;344
25.09.2023 16:00;309;590;154;89;224;184;115;167;;91;;361;138;342;899;243;408
25.09.2023 17:00;355;696;152;57;267;186;94;261;;113;;433;133;358;1051;209;453
25.09.2023 18:00;344;628;123;47;205;171;66;227;;84;;323;138;301;972;170;376
25.09.2023 19:00;268;384;62;35;103;98;54;127;;54;;187;75;201;652;97;201
25.09.2023 20:00;139;262;25;8;66;43;7;31;;28;;78;20;71;401;33;109
25.09.2023 21:00;82;164;13;8;43;21;4;18;;18;;43;13;38;246;21;64
25.09.2023 22:00;73;140;10;9;26;10;3;15;;12;;25;2;38;213;19;36
25.09.2023 23:00;35;59;6;4;9;9;0;5;;3;;9;6;6;94;10;18
26.09.2023 00:00;4;15;3;4;9;1;0;3;;0;;6;1;2;19;7;10
26.09.2023 01:00;5;6;1;0;0;0;0;0;;1;;1;0;1;11;1;0
26.09.2023 02:00;4;5;0;0;0;1;0;0;;0;;0;0;0;9;0;1
26.09.2023 03:00;5;3;0;1;2;1;1;0;;0;;0;0;0;8;1;3
26.09.2023 04:00;4;8;2;2;4;2;0;1;;0;;2;2;2;12;4;6
26.09.2023 05:00;59;50;20;15;29;12;6;7;;3;;14;4;13;109;35;41
26.09.2023 06:00;131;143;53;52;72;54;28;36;;11;;59;33;46;274;105;126
26.09.2023 07:00;474;406;99;84;216;198;83;183;;76;;314;99;205;880;183;414
26.09.2023 08:00;507;499;100;43;286;255;62;222;;74;;462;81;240;1006;143;541
26.09.2023 09:00;262;277;57;23;123;117;21;87;;26;;233;42;127;539;80;240
26.09.2023 10:00;205;202;49;35;79;64;54;120;;30;;151;71;119;407;84;143
26.09.2023 11:00;166;283;67;22;83;70;52;138;;36;;204;118;153;449;89;153
26.09.2023 12:00;200;325;68;37;102;82;78;198;;48;;235;176;191;525;105;184
26.09.2023 13:00;229;441;88;50;113;113;84;213;;68;;229;159;226;670;138;226
26.09.2023 14:00;242;440;90;90;137;129;107;220;;72;;289;166;266;682;180;266
26.09.2023 15:00;263;536;125;62;217;135;99;274;;67;;346;181;288;799;187;352
26.09.2023 16:00;361;659;158;80;304;185;113;297;;122;;400;207;382;1020;238;489
26.09.2023 17:00;351;737;158;104;303;247;140;290;;112;;500;195;459;1088;262;550
26.09.2023 18:00;353;577;137;68;238;184;91;220;;82;;378;151;327;930;205;422
26.09.2023 19:00;248;379;75;34;127;102;43;153;;85;;214;95;206;627;109;229
26.09.2023 20:00;128;260;27;16;61;42;10;33;;26;;67;22;81;388;43;103
26.09.2023 21:00;125;166;13;9;32;19;2;22;;13;;48;10;52;291;22;51
26.09.2023 22:00;73;116;10;7;29;8;2;17;;12;;26;10;25;189;17;37
26.09.2023 23:00;26;59;8;4;13;7;0;4;;3;;12;2;10;85;12;20
27.09.2023 00:00;13;23;2;1;1;1;0;0;;4;;0;1;5;36;3;2
27.09.2023 01:00;8;16;2;0;0;1;3;0;;1;;6;2;7;24;2;1
27.09.2023 02:00;5;5;1;2;0;0;0;0;;0;;0;0;1;10;3;0
27.09.2023 03:00;3;4;0;2;4;2;1;0;;0;;2;0;0;7;2;6
27.09.2023 04:00;8;9;1;2;5;3;0;0;;0;;0;3;5;17;3;8
27.09.2023 05:00;52;50;16;13;32;13;2;8;;4;;15;6;14;102;29;45
27.09.2023 06:00;122;131;39;52;80;51;27;32;;7;;61;26;41;253;91;131
27.09.2023 07:00;436;379;103;67;222;191;70;160;;79;;299;77;220;815;170;413
27.09.2023 08:00;535;466;76;52;268;250;80;205;;55;;481;79;230;1001;128;518
27.09.2023 09:00;225;272;44;24;116;100;41;152;;48;;236;96;107;497;68;216
27.09.2023 10:00;197;239;53;37;66;90;79;104;;30;;141;75;119;436;90;156
27.09.2023 11:00;186;264;41;30;87;80;70;163;;27;;162;116;143;450;71;167
27.09.2023 12:00;180;312;46;25;99;86;69;143;;50;;184;116;131;492;71;185
27.09.2023 13:00;242;449;97;34;113;95;106;226;;75;;220;203;214;691;131;208
27.09.2023 14:00;238;462;93;58;193;141;107;215;;49;;298;165;280;700;151;334
27.09.2023 15:00;299;514;105;57;214;140;100;230;;98;;328;153;315;813;162;354
27.09.2023 16:00;329;635;156;85;253;189;121;289;;95;;447;167;355;964;241;442
27.09.2023 17:00;349;737;124;68;261;230;109;248;;88;;470;190;382;1086;192;491
27.09.2023 18:00;353;569;117;73;229;199;101;253;;107;;387;160;378;922;190;428
27.09.2023 19:00;244;496;68;32;124;113;43;144;;64;;227;90;202;740;100;237
27.09.2023 20:00;154;261;34;9;77;39;6;49;;29;;102;28;104;415;43;116
27.09.2023 21:00;114;170;16;7;48;26;4;22;;30;;59;23;49;284;23;74
27.09.2023 22:00;148;168;19;9;22;14;6;18;;12;;35;10;27;316;28;36
27.09.2023 23:00;65;68;4;2;11;12;0;5;;4;;12;1;14;133;6;23
28.09.2023 00:00;9;28;4;0;7;2;0;2;;0;;5;2;2;37;4;9
28.09.2023 01:00;15;13;0;1;1;5;2;1;;1;;6;2;2;28;1;6
28.09.2023 02:00;4;10;3;0;1;0;0;0;;0;;3;0;1;14;3;1
28.09.2023 03:00;0;3;2;1;5;1;1;0;;0;;1;0;1;3;3;6
28.09.2023 04:00;8;7;0;3;4;3;1;2;;0;;4;7;5;15;3;7
28.09.2023 05:00;59;43;18;8;25;11;3;10;;4;;16;7;11;102;26;36
28.09.2023 06:00;127;131;42;45;91;46;18;38;;4;;68;28;54;258;87;137
28.09.2023 07:00;454;378;98;72;193;191;61;147;;78;;270;82;210;832;170;384
28.09.2023 08:00;487;443;75;57;291;250;67;233;;60;;465;108;222;930;132;541
28.09.2023 09:00;277;250;46;25;103;104;61;147;;55;;198;64;152;527;71;207
28.09.2023 10:00;208;252;56;26;56;59;58;113;;42;;165;78;99;460;82;115
28.09.2023 11:00;170;315;33;29;77;57;68;174;;57;;200;140;148;485;62;134
28.09.2023 12:00;193;340;71;40;108;84;67;156;;48;;213;127;152;533;111;192
28.09.2023 13:00;198;441;69;28;120;94;117;167;;57;;258;132;198;639;97;214
28.09.2023 14:00;242;450;83;49;165;119;81;219;;63;;271;154;212;692;132;284
28.09.2023 15:00;293;505;98;45;228;128;102;234;;77;;292;181;233;798;143;356
28.09.2023 16:00;327;672;153;62;233;197;93;234;;103;;342;176;331;999;215;430
28.09.2023 17:00;339;684;122;59;253;220;77;255;;110;;438;189;349;1023;181;473
28.09.2023 18:00;291;621;135;58;181;164;101;194;;79;;357;158;295;912;193;345
28.09.2023 19:00;280;411;70;39;136;106;39;113;;66;;213;103;211;691;109;242
28.09.2023 20:00;157;253;26;15;55;43;14;50;;24;;86;43;69;410;41;98
28.09.2023 21:00;89;186;17;4;33;22;9;23;;16;;54;16;51;275;21;55
28.09.2023 22:00;88;175;19;4;14;17;5;28;;8;;34;12;30;263;23;31
28.09.2023 23:00;41;70;6;2;6;12;0;5;;7;;12;3;15;111;8;18
29.09.2023 00:00;13;27;5;1;4;3;1;2;;1;;7;2;4;40;6;7
29.09.2023 01:00;7;16;0;0;1;2;1;1;;0;;7;3;6;23;0;3
29.09.2023 02:00;4;7;1;0;3;0;1;0;;1;;2;0;1;11;1;3
29.09.2023 03:00;2;7;0;1;2;0;0;0;;0;;0;0;1;9;1;2
29.09.2023 04:00;3;9;3;1;6;2;1;3;;0;;1;2;0;12;4;8
29.09.2023 05:00;38;35;5;11;12;11;3;9;;3;;13;4;10;73;16;23
29.09.2023 06:00;105;89;41;32;62;35;22;27;;5;;44;24;39;194;73;97
29.09.2023 07:00;309;295;59;69;125;135;41;113;;45;;182;63;138;604;128;260
29.09.2023 08:00;331;320;52;37;146;120;34;144;;43;;224;76;120;651;89;266
29.09.2023 09:00;204;252;44;19;86;67;30;77;;30;;134;39;83;456;63;153
29.09.2023 10:00;182;259;31;18;47;52;50;80;;34;;117;66;102;441;49;99
29.09.2023 11:00;191;281;45;19;66;55;25;101;;35;;125;82;130;472;64;121
29.09.2023 12:00;205;374;88;25;77;66;39;102;;28;;164;83;147;579;113;143
29.09.2023 13:00;237;454;81;31;97;79;61;134;;64;;193;103;140;691;112;176
29.09.2023 14:00;240;431;81;40;122;102;58;104;;61;;181;92;145;671;121;224
29.09.2023 15:00;237;436;79;40;140;99;63;162;;56;;228;115;141;673;119;239
29.09.2023 16:00;219;414;60;32;139;96;41;121;;34;;188;99;131;633;92;235
29.09.2023 17:00;228;428;45;31;107;86;52;99;;52;;191;82;171;656;76;193
29.09.2023 18:00;182;318;52;16;71;59;37;74;;41;;110;54;84;500;68;130
29.09.2023 19:00;136;271;25;13;44;29;17;31;;25;;57;16;51;407;38;73
29.09.2023 20:00;112;156;33;6;26;25;8;19;;13;;32;9;26;268;39;51
29.09.2023 21:00;49;117;8;8;20;10;7;16;;3;;22;14;15;166;16;30
29.09.2023 22:00;47;135;7;7;12;15;2;5;;8;;28;9;5;182;14;27
29.09.2023 23:00;41;80;11;10;24;7;0;6;;2;;21;4;8;121;21;31
30.09.2023 00:00;24;57;3;1;7;3;0;5;;1;;7;2;6;81;4;10
30.09.2023 01:00;17;37;2;1;6;0;0;1;;5;;3;2;3;54;3;6
30.09.2023 02:00;5;28;1;0;4;2;0;2;;2;;1;0;6;33;1;6
30.09.2023 03:00;9;11;1;0;3;1;2;2;;0;;2;1;2;20;1;4
30.09.2023 04:00;2;19;0;0;0;1;1;2;;0;;1;2;1;21;0;1
30.09.2023 05:00;11;13;2;1;9;2;1;0;;0;;3;1;2;24;3;11
30.09.2023 06:00;14;13;4;1;11;5;0;2;;1;;5;2;3;27;5;16
30.09.2023 07:00;14;41;10;4;10;11;7;14;;10;;17;8;13;55;14;21
30.09.2023 08:00;52;68;19;10;27;20;7;26;;10;;51;27;40;120;29;47
30.09.2023 09:00;100;138;62;20;28;25;28;58;;16;;78;62;61;238;82;53
30.09.2023 10:00;159;218;34;32;64;51;58;113;;39;;133;72;133;377;66;115
30.09.2023 11:00;192;272;63;36;80;56;67;160;;51;;206;148;204;464;99;136
30.09.2023 12:00;265;298;56;41;82;70;103;193;;61;;244;161;220;563;97;152
30.09.2023 13:00;236;357;93;28;103;87;117;245;;62;;292;186;207;593;121;190
30.09.2023 14:00;224;412;85;53;132;100;96;259;;67;;347;204;291;636;138;232
30.09.2023 15:00;298;416;72;68;131;93;123;235;;66;;331;205;326;714;140;224
30.09.2023 16:00;246;419;83;54;138;112;140;244;;70;;314;202;335;665;137;250
30.09.2023 17:00;224;415;66;30;130;104;108;205;;84;;291;160;268;639;96;234
30.09.2023 18:00;242;440;40;45;102;77;66;184;;53;;192;125;198;682;85;179
30.09.2023 19:00;135;304;26;24;62;39;26;92;;26;;112;63;95;439;50;101
30.09.2023 20:00;77;192;13;7;35;14;11;37;;33;;51;29;68;269;20;49
30.09.2023 21:00;60;125;13;5;20;18;3;24;;16;;25;6;47;185;18;38
30.09.2023 22:00;72;137;8;3;45;13;8;17;;7;;30;7;37;209;11;58
30.09.2023 23:00;56;89;9;3;7;8;0;11;;4;;11;3;19;145;12;15
01.10.2023 00:00;28;56;2;1;12;6;1;10;;2;;6;2;5;84;3;18
01.10.2023 01:00;26;34;10;7;4;5;1;3;;1;;5;1;8;60;17;9
01.10.2023 02:00;16;15;5;0;2;0;0;1;;0;;8;6;2;31;5;2
01.10.2023 03:00;6;15;2;0;5;0;3;3;;1;;3;1;0;21;2;5
01.10.2023 04:00;5;4;0;0;4;1;3;1;;1;;3;1;1;9;0;5
01.10.2023 05:00;6;7;2;0;3;1;0;0;;1;;2;2;2;13;2;4
01.10.2023 06:00;10;10;4;1;3;5;0;4;;1;;4;5;6;20;5;8
01.10.2023 07:00;17;29;4;2;12;15;4;11;;3;;19;6;21;46;6;27
01.10.2023 08:00;36;52;23;7;25;18;6;27;;16;;37;29;31;88;30;43
01.10.2023 09:00;56;81;36;25;54;50;35;65;;16;;92;63;79;137;61;104
01.10.2023 10:00;118;159;67;51;92;82;89;149;;38;;196;118;172;277;118;174
01.10.2023 11:00;219;239;105;75;148;132;163;343;;61;;313;274;329;458;180;280
01.10.2023 12:00;316;306;131;79;145;128;187;436;;81;;487;329;382;622;210;273
01.10.2023 13:00;412;393;135;72;226;150;271;576;;91;;576;476;477;805;207;376
01.10.2023 14:00;359;489;147;91;221;219;248;472;;93;;615;429;552;848;238;440
01.10.2023 15:00;372;560;154;103;277;212;248;494;;157;;537;437;586;932;257;489
01.10.2023 16:00;331;555;135;63;293;178;230;510;;119;;530;372;531;886;198;471
01.10.2023 17:00;354;541;159;107;209;182;185;372;;105;;441;314;427;895;266;391
01.10.2023 18:00;290;398;131;87;148;109;123;227;;82;;320;193;408;688;218;257
01.10.2023 19:00;246;305;62;44;123;80;66;137;;73;;168;113;214;551;106;203
01.10.2023 20:00;136;182;25;19;57;16;9;30;;13;;55;36;64;318;44;73
01.10.2023 21:00;62;92;16;10;19;12;2;13;;9;;42;10;35;154;26;31
01.10.2023 22:00;34;70;10;4;19;2;4;8;;0;;8;1;11;104;14;21
01.10.2023 23:00;26;34;6;3;8;11;4;2;;2;;8;3;13;60;9;19
02.10.2023 00:00;10;9;0;1;1;5;0;1;;0;;1;2;6;19;1;6
02.10.2023 01:00;12;12;5;0;1;2;0;0;;0;;0;1;1;24;5;3
02.10.2023 02:00;5;1;0;0;1;0;1;0;;0;;1;0;1;6;0;1
02.10.2023 03:00;2;5;2;2;2;0;3;0;;0;;0;0;0;7;4;2
02.10.2023 04:00;9;4;0;0;1;2;0;2;;1;;1;1;1;13;0;3
02.10.2023 05:00;45;34;14;8;7;9;3;4;;3;;8;5;10;79;22;16
02.10.2023 06:00;84;82;23;21;39;24;14;17;;7;;33;15;33;166;44;63
02.10.2023 07:00;198;196;35;25;92;75;24;81;;25;;127;52;68;394;60;167
02.10.2023 08:00;264;210;48;34;118;118;33;198;;29;;223;64;87;474;82;236
02.10.2023 09:00;188;220;26;31;54;67;42;82;;33;;160;58;91;408;57;121
02.10.2023 10:00;194;196;48;33;92;66;74;139;;28;;186;132;150;390;81;158
02.10.2023 11:00;192;276;47;33;83;69;91;255;;48;;241;219;217;468;80;152
02.10.2023 12:00;199;313;76;32;123;69;156;311;;57;;301;268;270;512;108;192
02.10.2023 13:00;209;363;83;60;124;93;121;342;;84;;350;278;322;572;143;217
02.10.2023 14:00;278;451;119;65;157;114;137;352;;92;;398;291;342;729;184;271
02.10.2023 15:00;271;496;129;95;175;148;194;369;;76;;425;279;408;767;224;323
02.10.2023 16:00;305;550;149;69;230;159;185;357;;92;;460;296;419;855;218;389
02.10.2023 17:00;304;576;129;73;216;207;149;333;;117;;405;215;438;880;202;423
02.10.2023 18:00;290;452;111;57;181;122;106;245;;86;;328;199;348;742;168;303
02.10.2023 19:00;250;367;61;42;111;76;48;156;;68;;178;99;236;617;103;187
02.10.2023 20:00;141;208;32;11;64;33;18;49;;45;;82;50;95;349;43;97
02.10.2023 21:00;89;153;16;10;26;28;5;26;;18;;36;25;47;242;26;54
02.10.2023 22:00;77;128;6;4;11;21;2;11;;9;;17;10;32;205;10;32
02.10.2023 23:00;59;72;11;7;9;10;4;6;;12;;13;4;22;131;18;19
03.10.2023 00:00;41;42;7;3;7;3;4;2;;7;;10;0;8;83;10;10
03.10.2023 01:00;15;34;3;0;7;7;0;1;;2;;9;2;9;49;3;14
03.10.2023 02:00;18;36;1;0;7;2;0;1;;7;;1;1;3;54;1;9
03.10.2023 03:00;12;15;3;1;1;0;3;1;;3;;3;1;0;27;4;1
03.10.2023 04:00;14;13;1;0;0;0;1;1;;4;;2;1;1;27;1;0
03.10.2023 05:00;7;26;0;1;2;0;1;0;;0;;1;1;2;33;1;2
03.10.2023 06:00;9;14;1;4;3;3;2;6;;2;;5;5;3;23;5;6
03.10.2023 07:00;19;25;15;6;8;11;9;11;;2;;24;6;10;44;21;19
03.10.2023 08:00;45;53;17;13;22;23;19;35;;10;;60;37;44;98;30;45
03.10.2023 09:00;71;99;73;25;44;40;50;90;;29;;102;82;90;170;98;84
03.10.2023 10:00;92;144;51;24;83;86;71;137;;37;;161;131;119;236;75;169
03.10.2023 11:00;106;136;44;28;83;59;67;158;;37;;163;160;140;242;72;142
03.10.2023 12:00;112;167;42;16;66;67;59;125;;18;;141;101;90;279;58;133
03.10.2023 13:00;88;125;20;7;32;21;29;73;;19;;66;90;53;213;27;53
03.10.2023 14:00;33;80;3;3;29;9;10;22;;9;;27;35;21;113;6;38
03.10.2023 15:00;57;64;11;5;5;17;11;35;;12;;46;34;26;121;16;22
03.10.2023 16:00;74;140;30;17;33;33;30;65;;37;;100;58;71;214;47;66
03.10.2023 17:00;111;136;43;20;40;54;37;98;;51;;121;85;113;247;63;94
03.10.2023 18:00;99;160;25;22;48;40;30;82;;27;;121;82;112;259;47;88
03.10.2023 19:00;112;144;15;3;42;29;7;57;;20;;72;32;56;256;18;71
03.10.2023 20:00;60;86;5;5;19;15;3;11;;8;;30;9;26;146;10;34
03.10.2023 21:00;45;90;7;2;16;10;1;8;;5;;13;7;14;135;9;26
03.10.2023 22:00;37;59;4;4;11;8;2;8;;6;;15;3;8;96;8;19
03.10.2023 23:00;13;33;3;3;7;2;0;1;;3;;3;1;4;46;6;9
04.10.2023 00:00;9;19;4;0;1;2;2;0;;1;;1;0;0;28;4;3
04.10.2023 01:00;4;10;1;0;1;0;1;0;;0;;1;0;0;14;1;1
04.10.2023 02:00;0;4;0;0;0;0;1;0;;0;;0;0;0;4;0;0
04.10.2023 03:00;0;3;0;1;3;0;0;0;;0;;0;0;0;3;1;3
04.10.2023 04:00;3;10;1;3;6;0;1;2;;0;;0;3;2;13;4;6
04.10.2023 05:00;44;42;13;9;24;15;6;7;;4;;15;6;12;86;22;39
04.10.2023 06:00;128;140;27;40;76;46;22;25;;10;;50;20;49;268;67;122
04.10.2023 07:00;291;256;66;44;153;130;43;115;;36;;192;68;119;547;110;283
04.10.2023 08:00;386;363;55;32;233;202;58;195;;48;;384;70;162;749;87;435
04.10.2023 09:00;219;216;51;20;76;87;37;88;;27;;176;45;77;435;71;163
04.10.2023 10:00;158;232;27;18;57;49;47;77;;36;;134;90;85;390;45;106
04.10.2023 11:00;166;249;53;19;56;71;66;113;;35;;157;102;119;415;72;127
04.10.2023 12:00;153;292;35;16;70;59;56;133;;42;;159;106;106;445;51;129
04.10.2023 13:00;185;346;47;17;88;66;52;146;;34;;169;101;144;531;64;154
04.10.2023 14:00;157;330;54;25;110;78;56;134;;42;;202;96;172;487;79;188
04.10.2023 15:00;261;414;80;28;149;119;66;184;;61;;241;141;185;675;108;268
04.10.2023 16:00;266;485;106;57;215;149;89;179;;69;;273;132;238;751;163;364
04.10.2023 17:00;303;558;97;56;223;173;76;186;;89;;350;128;230;861;153;396
04.10.2023 18:00;262;456;65;36;163;114;44;161;;63;;284;114;201;718;101;277
04.10.2023 19:00;192;332;38;25;86;66;18;89;;38;;163;56;113;524;63;152
04.10.2023 20:00;104;217;25;5;34;25;3;25;;21;;59;24;50;321;30;59
04.10.2023 21:00;79;107;10;8;31;10;3;21;;11;;38;16;20;186;18;41
04.10.2023 22:00;57;141;11;4;15;14;2;8;;5;;29;10;14;198;15;29
04.10.2023 23:00;50;52;10;2;11;7;2;6;;5;;9;3;4;102;12;18
05.10.2023 00:00;8;25;4;2;2;5;1;0;;2;;10;0;1;33;6;7
05.10.2023 01:00;5;12;2;1;2;1;0;1;;0;;3;0;1;17;3;3
05.10.2023 02:00;1;10;1;0;1;1;0;0;;0;;1;0;1;11;1;2
05.10.2023 03:00;4;4;2;1;5;0;1;0;;0;;0;0;0;8;3;5
05.10.2023 04:00;7;6;3;1;4;2;2;1;;0;;3;4;3;13;4;6
05.10.2023 05:00;43;44;13;6;22;13;5;10;;2;;11;7;12;87;19;35
05.10.2023 06:00;131;124;36;31;67;35;13;33;;8;;51;23;39;255;67;102
05.10.2023 07:00;306;252;52;41;162;128;41;111;;28;;188;63;98;558;93;290
05.10.2023 08:00;378;355;55;33;210;193;33;210;;53;;378;65;167;733;88;403
05.10.2023 09:00;199;232;32;18;83;72;39;84;;41;;164;41;74;431;50;155
05.10.2023 10:00;196;197;29;15;62;41;31;95;;38;;111;48;73;393;44;103
05.10.2023 11:00;146;227;32;20;80;45;35;92;;35;;121;77;93;373;52;125
05.10.2023 12:00;161;273;40;23;59;61;42;105;;24;;148;91;115;434;63;120
05.10.2023 13:00;157;295;36;14;76;49;33;94;;30;;157;65;78;452;50;125
05.10.2023 14:00;189;329;41;30;87;55;40;123;;30;;178;106;115;518;71;142
05.10.2023 15:00;201;389;62;25;130;115;61;171;;67;;212;97;170;590;87;245
05.10.2023 16:00;276;515;90;37;184;117;67;162;;63;;280;89;185;791;127;301
05.10.2023 17:00;272;614;88;59;197;184;55;198;;91;;383;119;253;886;147;381
05.10.2023 18:00;255;512;87;26;156;122;60;156;;69;;256;98;207;767;113;278
05.10.2023 19:00;210;316;47;28;70;72;22;84;;38;;129;50;144;526;75;142
05.10.2023 20:00;111;178;23;9;26;26;5;20;;18;;47;17;47;289;32;52
05.10.2023 21:00;87;141;14;4;25;16;4;25;;17;;37;14;17;228;18;41
05.10.2023 22:00;64;128;16;3;24;12;2;11;;9;;32;6;17;192;19;36
05.10.2023 23:00;21;70;2;3;10;1;0;4;;1;;12;4;5;91;5;11
06.10.2023 00:00;8;21;3;0;5;2;1;0;;0;;4;4;4;29;3;7
06.10.2023 01:00;5;20;0;1;6;2;0;0;;1;;1;1;0;25;1;8
06.10.2023 02:00;2;10;0;1;0;1;0;0;;0;;4;0;0;12;1;1
06.10.2023 03:00;4;10;0;1;5;0;1;2;;0;;1;1;1;14;1;5
06.10.2023 04:00;9;8;0;0;5;1;0;1;;0;;2;3;2;17;0;6
06.10.2023 05:00;34;41;12;7;18;12;4;4;;2;;11;4;11;75;19;30
06.10.2023 06:00;102;125;35;27;59;34;20;19;;6;;44;15;36;227;62;93
06.10.2023 07:00;211;204;42;28;102;75;30;75;;19;;135;45;70;415;70;177
06.10.2023 08:00;258;290;34;23;125;131;21;135;;36;;211;51;118;548;57;256
06.10.2023 09:00;193;206;38;16;67;52;26;46;;44;;138;47;90;399;54;119
06.10.2023 10:00;152;189;38;31;65;54;29;53;;28;;99;49;84;341;69;119
06.10.2023 11:00;156;237;38;36;52;51;39;101;;32;;134;78;118;393;74;103
06.10.2023 12:00;179;338;63;29;84;69;60;128;;35;;179;99;164;517;92;153
06.10.2023 13:00;221;361;72;31;109;56;85;172;;55;;190;117;158;582;103;165
06.10.2023 14:00;232;378;75;47;150;90;65;179;;76;;247;152;181;610;122;240
06.10.2023 15:00;250;451;69;57;137;138;83;209;;73;;247;190;238;701;126;275
06.10.2023 16:00;277;469;83;52;177;133;91;221;;103;;318;150;254;746;135;310
06.10.2023 17:00;257;430;88;56;155;121;99;157;;74;;264;148;294;687;144;276
06.10.2023 18:00;230;411;75;28;116;78;41;116;;59;;180;62;204;641;103;194
06.10.2023 19:00;184;331;40;26;64;54;34;63;;35;;108;57;113;515;66;118
06.10.2023 20:00;110;201;18;9;29;31;9;23;;17;;40;18;37;311;27;60
06.10.2023 21:00;68;126;7;4;20;11;1;24;;10;;36;17;27;194;11;31
06.10.2023 22:00;54;97;14;7;33;16;3;8;;12;;22;5;33;151;21;49
06.10.2023 23:00;48;66;5;3;14;6;4;1;;4;;9;2;11;114;8;20
07.10.2023 00:00;23;43;1;4;5;4;6;1;;0;;13;0;6;66;5;9
07.10.2023 01:00;19;38;0;2;3;2;0;4;;1;;6;2;8;57;2;5
07.10.2023 02:00;8;25;2;0;3;0;6;3;;0;;2;0;4;33;2;3
07.10.2023 03:00;8;5;5;0;2;2;0;2;;1;;1;1;0;13;5;4
07.10.2023 04:00;6;9;3;0;2;1;2;3;;1;;2;1;3;15;3;3
07.10.2023 05:00;9;20;2;2;5;3;1;0;;0;;6;1;2;29;4;8
07.10.2023 06:00;12;18;7;2;2;6;2;4;;4;;4;8;6;30;9;8
07.10.2023 07:00;18;30;8;6;7;10;2;4;;2;;26;2;11;48;14;17
07.10.2023 08:00;48;55;21;10;16;19;7;21;;8;;31;28;24;103;31;35
07.10.2023 09:00;110;142;17;19;41;23;21;40;;19;;55;34;54;252;36;64
07.10.2023 10:00;149;196;32;21;37;47;37;69;;43;;116;60;93;345;53;84
07.10.2023 11:00;196;257;47;36;69;52;60;114;;49;;156;108;166;453;83;121
07.10.2023 12:00;211;289;57;31;82;69;84;213;;61;;215;164;222;500;88;151
07.10.2023 13:00;224;376;108;76;130;83;122;244;;57;;292;180;281;600;184;213
07.10.2023 14:00;260;377;120;47;152;101;169;308;;71;;323;262;327;637;167;253
07.10.2023 15:00;260;447;109;55;143;151;115;332;;97;;358;236;432;707;164;294
07.10.2023 16:00;239;367;108;71;144;121;129;225;;91;;324;217;381;606;179;265
07.10.2023 17:00;284;370;89;62;156;154;140;280;;90;;285;225;331;654;151;310
07.10.2023 18:00;263;356;72;50;125;94;80;189;;84;;220;137;280;619;122;219
07.10.2023 19:00;188;193;54;28;82;40;30;75;;34;;114;57;160;381;82;122
07.10.2023 20:00;84;142;14;15;19;23;4;27;;24;;46;27;55;226;29;42
07.10.2023 21:00;63;124;13;11;16;10;3;14;;8;;26;13;25;187;24;26
07.10.2023 22:00;52;92;10;7;21;4;1;7;;5;;20;5;19;144;17;25
07.10.2023 23:00;39;80;7;8;4;9;0;8;;4;;8;8;17;119;15;13
08.10.2023 00:00;25;48;3;0;3;3;7;6;;0;;6;1;3;73;3;6
08.10.2023 01:00;11;44;4;0;5;4;1;1;;1;;3;1;6;55;4;9
08.10.2023 02:00;10;24;1;0;2;3;0;0;;2;;2;0;7;34;1;5
08.10.2023 03:00;5;9;0;0;0;1;1;0;;0;;2;0;2;14;0;1
08.10.2023 04:00;6;14;3;0;0;0;0;0;;1;;0;0;1;20;3;0
08.10.2023 05:00;9;16;0;3;4;1;0;1;;1;;4;0;2;25;3;5
08.10.2023 06:00;11;14;4;3;2;4;2;6;;1;;5;6;2;25;7;6
08.10.2023 07:00;9;15;6;4;7;6;5;7;;0;;9;1;7;24;10;13
08.10.2023 08:00;18;43;16;8;14;13;10;21;;7;;43;22;19;61;24;27
08.10.2023 09:00;67;91;45;14;45;43;16;61;;17;;75;60;61;158;59;88
08.10.2023 10:00;82;113;56;23;72;71;78;130;;30;;135;118;122;195;79;143
08.10.2023 11:00;136;193;93;57;119;73;89;186;;56;;214;154;221;329;150;192
08.10.2023 12:00;156;197;107;55;163;114;132;308;;67;;294;212;278;353;162;277
08.10.2023 13:00;180;235;124;66;172;148;168;312;;77;;307;251;329;415;190;320
08.10.2023 14:00;204;286;145;92;215;154;157;395;;82;;425;301;392;490;237;369
08.10.2023 15:00;215;269;87;92;230;149;174;329;;98;;434;270;353;484;179;379
08.10.2023 16:00;197;253;80;41;134;113;100;244;;64;;287;203;287;450;121;247
08.10.2023 17:00;229;292;88;72;145;122;84;222;;54;;257;171;326;521;160;267
08.10.2023 18:00;182;244;70;37;83;60;56;151;;51;;173;94;186;426;107;143
08.10.2023 19:00;144;169;31;10;46;32;14;52;;20;;95;38;77;313;41;78
08.10.2023 20:00;94;128;13;17;20;14;9;19;;12;;46;13;40;222;30;34
08.10.2023 21:00;57;83;10;6;17;6;8;17;;8;;32;15;16;140;16;23
08.10.2023 22:00;45;40;5;2;20;6;0;4;;5;;10;5;11;85;7;26
08.10.2023 23:00;12;27;3;1;0;2;2;3;;2;;4;2;5;39;4;2
09.10.2023 00:00;6;14;1;0;5;2;0;3;;1;;2;2;2;20;1;7
09.10.2023 01:00;5;8;2;0;1;0;0;0;;1;;0;0;2;13;2;1
09.10.2023 02:00;1;6;0;0;0;1;0;2;;0;;1;0;0;7;0;1
09.10.2023 03:00;0;1;0;0;4;0;1;0;;0;;0;0;0;1;0;4
09.10.2023 04:00;6;15;2;1;3;4;1;0;;1;;4;1;2;21;3;7
09.10.2023 05:00;38;45;10;11;25;8;3;6;;2;;12;8;9;83;21;33
09.10.2023 06:00;120;134;26;36;71;49;27;29;;12;;49;18;43;254;62;120
09.10.2023 07:00;319;257;69;51;163;97;49;90;;29;;177;56;100;576;120;260
09.10.2023 08:00;364;346;56;31;197;169;47;137;;45;;328;59;140;710;87;366
09.10.2023 09:00;206;246;34;17;63;88;36;93;;35;;151;40;78;452;51;151
09.10.2023 10:00;158;172;24;28;45;37;30;66;;17;;101;58;73;330;52;82
09.10.2023 11:00;146;223;28;22;47;49;23;88;;31;;102;86;86;369;50;96
09.10.2023 12:00;157;261;36;19;53;53;31;89;;41;;136;74;86;418;55;106
09.10.2023 13:00;184;299;52;23;89;63;57;98;;47;;152;80;112;483;75;152
09.10.2023 14:00;161;350;57;22;97;77;58;123;;49;;196;89;140;511;79;174
09.10.2023 15:00;248;439;73;36;148;98;52;143;;59;;211;117;181;687;109;246
09.10.2023 16:00;262;481;120;39;211;132;65;189;;68;;305;106;210;743;159;343
09.10.2023 17:00;275;587;97;57;230;166;85;212;;86;;314;143;245;862;154;396
09.10.2023 18:00;239;461;97;34;168;116;81;169;;58;;269;99;248;700;131;284
09.10.2023 19:00;186;309;47;30;59;73;33;81;;24;;117;39;122;495;77;132
09.10.2023 20:00;117;190;22;4;31;16;7;22;;11;;49;11;41;307;26;47
09.10.2023 21:00;80;129;10;7;16;15;2;13;;20;;32;11;34;209;17;31
09.10.2023 22:00;55;108;21;3;12;9;4;5;;6;;22;4;18;163;24;21
09.10.2023 23:00;25;35;5;3;9;7;2;2;;5;;9;0;6;60;8;16
10.10.2023 00:00;8;18;3;4;3;0;6;0;;1;;2;3;2;26;7;3
10.10.2023 01:00;5;4;0;0;5;2;2;1;;0;;0;3;3;9;0;7
10.10.2023 02:00;3;7;0;1;3;1;0;1;;0;;4;3;0;10;1;4
10.10.2023 03:00;2;2;1;0;3;0;1;4;;1;;0;0;0;4;1;3
10.10.2023 04:00;2;8;0;4;1;3;0;0;;0;;3;2;0;10;4;4
10.10.2023 05:00;55;45;14;12;27;14;5;6;;2;;13;4;13;100;26;41
10.10.2023 06:00;139;128;25;45;67;48;18;27;;9;;63;27;42;267;70;115
10.10.2023 07:00;320;277;76;43;182;109;57;111;;42;;207;58;113;597;119;291
10.10.2023 08:00;404;410;72;34;232;219;56;155;;38;;371;70;153;814;106;451
10.10.2023 09:00;241;246;43;27;95;90;42;99;;28;;193;56;97;487;70;185
10.10.2023 10:00;154;230;31;27;65;57;68;71;;37;;142;68;108;384;58;122
10.10.2023 11:00;180;224;64;33;64;66;51;135;;45;;148;116;129;404;97;130
10.10.2023 12:00;194;285;61;23;103;86;63;145;;48;;189;153;162;479;84;189
10.10.2023 13:00;184;324;81;28;112;76;76;228;;54;;230;149;164;508;109;188
10.10.2023 14:00;225;452;88;37;176;110;102;205;;73;;242;158;270;677;125;286
10.10.2023 15:00;279;467;129;56;219;116;90;275;;97;;320;210;284;746;185;335
10.10.2023 16:00;316;645;159;100;255;210;173;283;;100;;428;213;342;961;259;465
10.10.2023 17:00;348;708;153;80;291;243;130;293;;135;;477;184;449;1056;233;534
10.10.2023 18:00;383;563;113;64;224;175;88;246;;114;;346;148;396;946;177;399
10.10.2023 19:00;239;455;47;35;109;93;29;94;;70;;181;67;195;694;82;202
10.10.2023 20:00;150;196;24;16;45;29;8;37;;19;;57;18;67;346;40;74
10.10.2023 21:00;95;180;16;17;33;23;5;11;;13;;38;13;40;275;33;56
10.10.2023 22:00;74;124;9;6;20;12;1;13;;2;;19;4;19;198;15;32
10.10.2023 23:00;28;59;12;2;7;4;1;3;;1;;9;2;14;87;14;11
11.10.2023 00:00;15;20;0;1;1;1;0;1;;3;;7;0;1;35;1;2
11.10.2023 01:00;4;11;0;0;2;1;0;2;;0;;2;0;2;15;0;3
11.10.2023 02:00;3;5;0;0;0;0;0;1;;1;;0;2;2;8;0;0
11.10.2023 03:00;6;7;3;1;5;1;2;0;;0;;0;0;0;13;4;6
11.10.2023 04:00;6;4;4;1;4;3;1;2;;0;;1;3;0;10;5;7
11.10.2023 05:00;44;52;14;8;36;16;5;6;;5;;14;4;17;96;22;52
11.10.2023 06:00;124;125;26;47;76;43;18;36;;10;;40;22;45;249;73;119
11.10.2023 07:00;322;302;70;49;176;136;55;132;;51;;208;81;120;624;119;312
11.10.2023 08:00;405;408;67;44;238;200;60;156;;44;;395;67;160;813;111;438
11.10.2023 09:00;273;259;34;18;110;97;42;105;;37;;220;41;94;532;52;207
11.10.2023 10:00;183;282;36;30;78;53;58;121;;41;;157;94;129;465;66;131
11.10.2023 11:00;207;298;61;26;78;73;90;186;;45;;212;157;200;505;87;151
11.10.2023 12:00;232;331;65;41;127;90;94;250;;35;;211;164;188;563;106;217
11.10.2023 13:00;188;403;64;43;130;87;114;225;;59;;284;202;231;591;107;217
11.10.2023 14:00;201;447;95;56;152;100;136;298;;77;;309;173;265;648;151;252
11.10.2023 15:00;261;524;129;73;229;178;140;285;;93;;367;212;382;785;202;407
11.10.2023 16:00;323;648;168;74;284;215;171;286;;124;;456;224;431;971;242;499
11.10.2023 17:00;348;676;139;97;313;218;120;312;;136;;571;223;442;1024;236;531
11.10.2023 18:00;354;574;96;59;182;175;91;235;;104;;368;140;361;928;155;357
11.10.2023 19:00;214;419;48;48;99;100;31;112;;47;;180;68;159;633;96;199
11.10.2023 20:00;138;249;20;10;38;36;4;52;;20;;82;23;87;387;30;74
11.10.2023 21:00;116;163;24;9;27;18;5;25;;26;;56;15;61;279;33;45
11.10.2023 22:00;96;165;11;3;31;16;6;9;;15;;30;13;30;261;14;47
11.10.2023 23:00;31;65;10;4;7;1;1;2;;6;;10;5;18;96;14;8
12.10.2023 00:00;14;32;1;0;3;2;0;0;;6;;1;2;9;46;1;5
12.10.2023 01:00;14;15;1;0;2;0;2;0;;2;;3;6;3;29;1;2
12.10.2023 02:00;2;2;0;0;0;1;0;0;;0;;0;0;0;4;0;1
12.10.2023 03:00;3;6;0;1;3;0;2;0;;0;;2;0;1;9;1;3
12.10.2023 04:00;7;10;5;2;1;1;0;0;;0;;1;2;1;17;7;2
12.10.2023 05:00;33;33;9;5;23;8;1;8;;3;;10;5;5;66;14;31
12.10.2023 06:00;99;98;22;26;56;30;15;22;;6;;33;19;28;197;48;86
12.10.2023 07:00;210;212;37;39;97;81;22;53;;24;;110;25;62;422;76;178
12.10.2023 08:00;222;258;31;22;103;99;23;57;;22;;196;32;80;480;53;202
12.10.2023 09:00;111;156;22;10;38;47;22;32;;13;;87;13;34;267;32;85
12.10.2023 10:00;73;108;12;7;21;17;10;28;;10;;46;18;22;181;19;38
12.10.2023 11:00;80;127;7;13;16;24;16;34;;13;;43;32;30;207;20;40
12.10.2023 12:00;114;179;26;9;24;28;13;25;;20;;53;34;56;293;35;52
12.10.2023 13:00;118;216;42;11;38;56;21;47;;13;;73;38;52;334;53;94
12.10.2023 14:00;130;245;30;15;60;29;32;49;;19;;90;25;74;375;45;89
12.10.2023 15:00;84;243;33;8;55;42;20;33;;20;;102;29;34;327;41;97
12.10.2023 16:00;162;339;57;31;114;82;28;62;;26;;145;33;79;501;88;196
12.10.2023 17:00;198;397;43;18;109;85;21;57;;39;;180;40;91;595;61;194
12.10.2023 18:00;172;336;47;11;79;56;17;41;;34;;110;30;81;508;58;135
12.10.2023 19:00;125;237;16;13;51;26;13;19;;20;;63;16;49;362;29;77
12.10.2023 20:00;92;144;11;6;23;15;12;11;;8;;31;5;27;236;17;38
12.10.2023 21:00;62;110;12;4;22;14;2;17;;13;;31;9;27;172;16;36
12.10.2023 22:00;74;98;9;3;8;5;3;1;;8;;17;2;16;172;12;13
12.10.2023 23:00;34;58;7;1;2;4;3;2;;1;;6;2;5;92;8;6
13.10.2023 00:00;4;21;7;0;2;2;0;0;;1;;5;3;2;25;7;4
13.10.2023 01:00;3;21;1;0;3;2;0;0;;1;;0;0;0;24;1;5
13.10.2023 02:00;5;5;0;0;0;0;0;0;;0;;0;0;0;10;0;0
13.10.2023 03:00;3;2;0;0;2;0;0;0;;0;;0;0;0;5;0;2
13.10.2023 04:00;6;8;2;1;2;2;1;0;;0;;1;0;0;14;3;4
13.10.2023 05:00;30;27;5;3;22;13;4;4;;0;;10;5;3;57;8;35
13.10.2023 06:00;93;92;18;26;54;27;12;21;;8;;29;14;24;185;44;81
13.10.2023 07:00;177;217;37;29;77;72;28;53;;22;;95;39;76;394;66;149
13.10.2023 08:00;243;283;35;29;109;118;22;77;;31;;188;48;87;526;64;227
13.10.2023 09:00;180;221;33;18;59;71;24;48;;25;;112;39;68;401;51;130
13.10.2023 10:00;158;220;37;20;49;36;31;59;;25;;90;39;60;378;57;85
13.10.2023 11:00;140;279;34;12;52;38;25;87;;23;;95;84;105;419;46;90
13.10.2023 12:00;183;322;41;24;58;56;36;97;;51;;128;62;103;505;65;114
13.10.2023 13:00;183;329;54;26;83;71;70;99;;40;;176;79;124;512;80;154
13.10.2023 14:00;195;371;83;26;117;83;58;121;;48;;195;121;162;566;109;200
13.10.2023 15:00;211;368;80;49;115;95;70;132;;66;;196;113;164;579;129;210
13.10.2023 16:00;233;425;74;44;130;115;61;141;;78;;230;145;191;658;118;245
13.10.2023 17:00;239;390;49;37;115;94;54;144;;62;;196;102;202;629;86;209
13.10.2023 18:00;216;361;45;30;105;67;46;96;;54;;153;71;176;577;75;172
13.10.2023 19:00;194;268;31;17;38;38;17;36;;30;;83;28;90;462;48;76
13.10.2023 20:00;96;183;15;7;23;24;6;24;;11;;58;19;36;279;22;47
13.10.2023 21:00;92;122;10;10;21;12;7;10;;9;;26;8;32;214;20;33
13.10.2023 22:00;55;108;14;1;19;9;3;3;;9;;25;4;10;163;15;28
13.10.2023 23:00;44;86;5;2;6;12;0;5;;4;;25;1;7;130;7;18
14.10.2023 00:00;27;54;7;0;11;3;0;2;;4;;1;2;9;81;7;14
14.10.2023 01:00;13;47;9;3;7;3;1;0;;1;;2;1;8;60;12;10
14.10.2023 02:00;10;34;1;0;3;3;0;3;;0;;4;1;3;44;1;6
14.10.2023 03:00;6;20;2;0;2;2;0;4;;1;;2;3;1;26;2;4
14.10.2023 04:00;5;14;2;0;0;1;3;2;;0;;6;1;0;19;2;1
14.10.2023 05:00;6;10;2;0;1;0;1;0;;0;;1;1;1;16;2;1
14.10.2023 06:00;12;18;2;0;2;2;0;2;;1;;1;1;4;30;2;4
14.10.2023 07:00;17;20;4;5;6;8;2;4;;0;;8;3;8;37;9;14
14.10.2023 08:00;39;69;11;6;19;18;6;16;;10;;25;4;26;108;17;37
14.10.2023 09:00;84;115;25;9;30;31;9;51;;20;;51;29;59;199;34;61
14.10.2023 10:00;149;177;39;27;32;44;35;84;;35;;112;73;76;326;66;76
14.10.2023 11:00;134;246;46;21;53;52;54;130;;34;;135;98;139;380;67;105
14.10.2023 12:00;189;293;53;31;91;57;49;109;;33;;160;95;140;482;84;148
14.10.2023 13:00;174;311;58;45;88;70;68;135;;31;;214;91;151;485;103;158
14.10.2023 14:00;187;337;60;35;69;52;76;118;;58;;191;114;173;524;95;121
14.10.2023 15:00;175;318;63;32;108;73;55;167;;34;;210;109;175;493;95;181
14.10.2023 16:00;151;277;57;20;97;73;66;153;;53;;192;113;141;428;77;170
14.10.2023 17:00;154;283;47;29;69;71;41;105;;55;;164;68;124;437;76;140
14.10.2023 18:00;108;219;19;10;49;31;11;73;;24;;69;54;46;327;29;80
14.10.2023 19:00;112;165;5;11;29;26;5;17;;14;;51;22;32;277;16;55
14.10.2023 20:00;84;106;12;3;18;12;3;10;;13;;36;4;16;190;15;30
14.10.2023 21:00;64;89;10;2;11;5;0;14;;9;;14;9;12;153;12;16
14.10.2023 22:00;47;59;1;2;19;8;0;4;;0;;20;1;11;106;3;27
14.10.2023 23:00;37;72;12;3;9;12;2;2;;7;;12;1;8;109;15;21
15.10.2023 00:00;42;70;6;0;10;3;0;2;;8;;18;0;6;112;6;13
15.10.2023 01:00;19;38;1;1;7;5;0;2;;5;;12;2;3;57;2;12
15.10.2023 02:00;8;26;2;0;3;5;1;1;;1;;8;0;5;34;2;8
15.10.2023 03:00;6;14;2;2;1;0;1;3;;2;;6;1;3;20;4;1
15.10.2023 04:00;3;16;2;0;5;1;0;2;;0;;9;0;0;19;2;6
15.10.2023 05:00;4;9;1;0;3;0;0;1;;0;;2;1;3;13;1;3
15.10.2023 06:00;5;12;3;0;3;1;1;1;;2;;1;2;11;17;3;4
15.10.2023 07:00;6;11;3;6;5;7;1;7;;0;;4;2;3;17;9;12
15.10.2023 08:00;22;159;19;5;27;16;4;19;;18;;26;15;35;181;24;43
15.10.2023 09:00;59;156;20;7;41;18;10;28;;13;;54;32;44;215;27;59
15.10.2023 10:00;143;152;15;30;41;28;24;70;;28;;87;53;48;295;45;69
15.10.2023 11:00;95;150;19;14;32;28;21;44;;24;;39;36;66;245;33;60
15.10.2023 12:00;110;118;21;11;58;28;20;56;;13;;78;34;50;228;32;86
15.10.2023 13:00;105;133;37;20;38;42;27;49;;19;;82;80;89;238;57;80
15.10.2023 14:00;119;197;44;28;58;50;35;98;;56;;126;59;125;316;72;108
15.10.2023 15:00;127;205;55;32;71;62;74;125;;36;;152;115;154;332;87;133
15.10.2023 16:00;110;213;64;15;52;70;64;135;;37;;167;110;133;323;79;122
15.10.2023 17:00;135;251;41;39;62;91;42;123;;55;;168;75;171;386;80;153
15.10.2023 18:00;142;227;40;16;53;47;25;64;;46;;84;50;101;369;56;100
15.10.2023 19:00;82;166;17;7;19;20;4;21;;22;;27;19;42;248;24;39
15.10.2023 20:00;59;79;4;10;16;8;0;9;;12;;30;7;19;138;14;24
15.10.2023 21:00;53;65;8;1;14;8;4;9;;7;;10;6;7;118;9;22
15.10.2023 22:00;20;39;6;3;6;1;0;1;;1;;4;2;2;59;9;7
15.10.2023 23:00;20;26;0;1;8;4;0;0;;0;;3;1;3;46;1;12
16.10.2023 00:00;8;13;0;3;4;0;0;1;;2;;2;0;1;21;3;4
16.10.2023 01:00;2;4;0;0;0;0;0;0;;2;;0;0;0;6;0;0
16.10.2023 02:00;2;2;0;1;3;0;0;2;;0;;0;0;1;4;1;3
16.10.2023 03:00;0;1;0;0;3;0;0;0;;0;;0;0;0;1;0;3
16.10.2023 04:00;6;7;3;3;3;4;1;0;;0;;2;1;0;13;6;7
16.10.2023 05:00;37;41;16;6;20;11;7;6;;1;;13;2;3;78;22;31
16.10.2023 06:00;125;127;29;40;83;28;21;27;;11;;46;23;46;252;69;111
16.10.2023 07:00;409;382;80;82;189;173;57;104;;63;;198;56;193;791;162;362
16.10.2023 08:00;434;352;63;44;204;209;43;119;;59;;335;53;159;786;107;413
16.10.2023 09:00;226;261;34;13;93;74;16;75;;22;;140;33;70;487;47;167
16.10.2023 10:00;118;209;22;19;41;24;19;45;;16;;71;40;58;327;41;65
16.10.2023 11:00;138;213;32;16;54;51;17;21;;14;;78;30;70;351;48;105
16.10.2023 12:00;157;243;37;14;67;49;38;76;;22;;99;32;75;400;51;116
16.10.2023 13:00;170;343;44;25;89;56;34;73;;39;;140;33;131;513;69;145
16.10.2023 14:00;186;370;55;24;87;71;36;82;;43;;146;66;129;556;79;158
16.10.2023 15:00;237;399;62;41;141;113;43;106;;77;;181;69;149;636;103;254
16.10.2023 16:00;275;547;99;57;204;135;66;123;;67;;231;82;179;822;156;339
16.10.2023 17:00;260;578;87;49;198;147;67;140;;81;;308;101;201;838;136;345
16.10.2023 18:00;260;490;69;33;151;104;45;124;;59;;225;86;163;750;102;255
16.10.2023 19:00;186;299;34;17;64;38;10;47;;34;;91;23;81;485;51;102
16.10.2023 20:00;102;191;15;8;24;23;7;19;;16;;41;12;38;293;23;47
16.10.2023 21:00;63;150;10;6;21;11;0;7;;9;;30;8;17;213;16;32
16.10.2023 22:00;36;88;9;2;21;5;2;6;;2;;10;6;7;124;11;26
16.10.2023 23:00;18;28;3;5;7;3;2;0;;2;;8;0;3;46;8;10
17.10.2023 00:00;8;9;2;2;0;2;0;1;;1;;0;0;0;17;4;2
17.10.2023 01:00;0;7;0;0;0;1;0;0;;1;;0;0;0;7;0;1
17.10.2023 02:00;1;1;0;0;3;0;0;0;;0;;1;0;0;2;0;3
17.10.2023 03:00;1;0;0;0;3;0;1;1;;0;;0;1;0;1;0;3
17.10.2023 04:00;7;10;1;2;5;3;1;0;;0;;2;1;0;17;3;8
17.10.2023 05:00;44;38;21;9;15;14;3;9;;3;;16;7;7;82;30;29
17.10.2023 06:00;140;144;36;42;79;53;25;34;;10;;60;27;50;284;78;132
17.10.2023 07:00;426;374;85;83;198;172;60;125;;58;;222;56;158;800;168;370
17.10.2023 08:00;494;434;75;44;254;244;51;185;;55;;415;58;188;928;119;498
17.10.2023 09:00;226;271;36;18;118;90;22;89;;29;;170;40;70;497;54;208
17.10.2023 10:00;157;212;25;25;52;47;22;58;;21;;86;46;63;369;50;99
17.10.2023 11:00;141;228;35;16;61;43;12;48;;24;;84;47;66;369;51;104
17.10.2023 12:00;148;277;40;22;62;54;27;87;;30;;95;64;83;425;62;116
17.10.2023 13:00;185;359;47;17;84;78;25;112;;54;;156;56;116;544;64;162
17.10.2023 14:00;203;412;56;36;127;81;50;106;;75;;178;65;189;615;92;208
17.10.2023 15:00;271;475;113;36;161;142;58;160;;63;;245;89;203;746;149;303
17.10.2023 16:00;317;631;111;60;215;154;63;161;;84;;320;128;274;948;171;369
17.10.2023 17:00;315;713;116;64;282;178;71;198;;70;;379;112;317;1028;180;460
17.10.2023 18:00;296;552;96;47;136;135;67;145;;67;;257;101;226;848;143;271
17.10.2023 19:00;179;338;30;23;92;61;11;76;;46;;133;37;88;517;53;153
17.10.2023 20:00;102;211;13;9;37;29;3;13;;16;;37;10;35;313;22;66
17.10.2023 21:00;94;213;15;5;28;17;4;16;;7;;41;10;31;307;20;45
17.10.2023 22:00;60;113;15;5;25;10;3;15;;7;;24;6;10;173;20;35
17.10.2023 23:00;27;49;4;3;7;4;1;0;;0;;7;1;4;76;7;11
18.10.2023 00:00;11;18;5;1;4;2;0;0;;1;;1;0;5;29;6;6
18.10.2023 01:00;4;6;0;0;4;2;0;0;;0;;0;0;0;10;0;6
18.10.2023 02:00;2;5;0;0;0;0;0;0;;0;;0;0;0;7;0;0
18.10.2023 03:00;2;1;0;0;4;0;2;0;;0;;0;0;0;3;0;4
18.10.2023 04:00;7;5;0;1;5;3;0;0;;0;;3;2;2;12;1;8
18.10.2023 05:00;46;43;18;6;20;8;5;7;;2;;15;2;6;89;24;28
18.10.2023 06:00;141;113;26;48;75;37;21;26;;6;;46;14;41;254;74;112
18.10.2023 07:00;392;357;77;74;201;167;56;135;;57;;201;59;185;749;151;368
18.10.2023 08:00;499;435;67;34;250;260;49;190;;53;;382;65;175;934;101;510
18.10.2023 09:00;252;265;41;17;115;97;24;74;;33;;188;28;93;517;58;212
18.10.2023 10:00;161;222;19;22;52;43;19;50;;40;;102;42;70;383;41;95
18.10.2023 11:00;158;230;32;19;52;43;28;65;;24;;92;62;81;388;51;95
18.10.2023 12:00;174;258;39;18;53;50;39;76;;36;;132;66;103;432;57;103
18.10.2023 13:00;163;394;57;12;76;84;31;93;;47;;141;61;139;557;69;160
18.10.2023 14:00;191;377;44;41;115;88;49;105;;41;;180;60;166;568;85;203
18.10.2023 15:00;254;434;69;40;147;125;49;140;;49;;212;73;160;688;109;272
18.10.2023 16:00;258;559;110;38;203;132;61;132;;70;;248;80;201;817;148;335
18.10.2023 17:00;270;637;96;62;197;161;75;134;;70;;324;65;223;907;158;358
18.10.2023 18:00;249;513;55;35;119;114;36;109;;65;;228;65;143;762;90;233
18.10.2023 19:00;182;330;30;19;71;55;8;38;;29;;114;25;81;512;49;126
18.10.2023 20:00;103;210;22;6;37;31;2;21;;13;;47;8;32;313;28;68
18.10.2023 21:00;89;158;14;3;31;13;3;13;;7;;34;14;17;247;17;44
18.10.2023 22:00;57;110;6;3;16;7;3;6;;13;;19;5;8;167;9;23
18.10.2023 23:00;27;38;1;2;9;5;0;4;;3;;3;2;3;65;3;14
19.10.2023 00:00;10;22;0;0;2;1;0;2;;1;;4;1;5;32;0;3
19.10.2023 01:00;4;2;1;1;1;0;0;0;;0;;1;0;0;6;2;1
19.10.2023 02:00;2;6;0;0;2;0;0;2;;0;;0;1;0;8;0;2
19.10.2023 03:00;1;2;0;0;4;1;0;0;;0;;0;0;1;3;0;5
19.10.2023 04:00;8;7;1;0;5;4;0;2;;0;;5;3;2;15;1;9
19.10.2023 05:00;38;40;14;3;15;14;2;7;;3;;12;5;11;78;17;29
19.10.2023 06:00;120;123;28;32;62;40;14;24;;8;;46;16;37;243;60;102
19.10.2023 07:00;393;354;64;70;159;154;54;110;;54;;208;60;183;747;134;313
19.10.2023 08:00;422;407;66;38;233;217;39;181;;61;;320;61;153;829;104;450
19.10.2023 09:00;245;238;34;21;74;79;28;82;;23;;177;30;74;483;55;153
19.10.2023 10:00;137;196;29;15;41;47;28;46;;25;;89;31;65;333;44;88
19.10.2023 11:00;159;216;22;29;46;48;37;86;;29;;128;65;85;375;51;94
19.10.2023 12:00;156;279;57;23;64;62;29;105;;30;;129;66;115;435;80;126
19.10.2023 13:00;161;328;38;20;56;68;31;64;;37;;132;47;85;489;58;124
19.10.2023 14:00;157;297;37;22;102;66;31;57;;32;;114;35;88;454;59;168
19.10.2023 15:00;145;324;46;14;95;63;16;62;;27;;127;45;59;469;60;158
19.10.2023 16:00;188;403;75;30;110;86;28;51;;44;;138;24;96;591;105;196
19.10.2023 17:00;236;514;72;39;167;115;35;113;;57;;246;55;178;750;111;282
19.10.2023 18:00;228;470;49;26;121;98;31;108;;53;;192;52;143;698;75;219
19.10.2023 19:00;167;328;38;12;53;34;13;46;;33;;93;20;90;495;50;87
19.10.2023 20:00;111;189;13;6;28;19;8;19;;10;;33;8;35;300;19;47
19.10.2023 21:00;86;146;14;3;17;21;5;12;;8;;25;7;24;232;17;38
19.10.2023 22:00;70;152;12;6;22;7;6;9;;12;;28;5;12;222;18;29
19.10.2023 23:00;32;63;4;2;7;3;0;4;;4;;7;0;4;95;6;10
20.10.2023 00:00;10;26;1;1;2;6;1;2;;3;;5;0;1;36;2;8
20.10.2023 01:00;8;10;0;0;4;0;0;0;;1;;2;0;0;18;0;4
20.10.2023 02:00;5;6;1;0;0;0;0;0;;1;;1;0;0;11;1;0
20.10.2023 03:00;3;1;2;0;2;0;1;0;;1;;3;0;1;4;2;2
20.10.2023 04:00;5;8;0;0;4;2;0;1;;0;;2;1;0;13;0;6
20.10.2023 05:00;18;21;5;0;10;8;3;2;;1;;9;3;4;39;5;18
20.10.2023 06:00;64;73;12;15;23;13;8;8;;3;;17;7;18;137;27;36
20.10.2023 07:00;186;217;33;34;66;57;19;51;;22;;86;24;71;403;67;123
20.10.2023 08:00;200;197;33;17;78;67;8;54;;21;;117;18;50;397;50;145
20.10.2023 09:00;100;133;12;7;37;31;4;27;;12;;61;13;26;233;19;68
20.10.2023 10:00;80;109;7;10;23;14;4;20;;8;;29;14;26;189;17;37
20.10.2023 11:00;70;115;10;2;22;13;14;15;;14;;30;7;20;185;12;35
20.10.2023 12:00;99;162;27;11;21;30;5;26;;12;;45;8;41;261;38;51
20.10.2023 13:00;139;253;39;14;44;44;16;31;;37;;64;23;82;392;53;88
20.10.2023 14:00;136;287;36;15;61;50;10;37;;15;;81;17;66;423;51;111
20.10.2023 15:00;127;267;30;17;64;53;22;43;;26;;105;20;57;394;47;117
20.10.2023 16:00;117;251;41;22;49;39;25;39;;21;;74;37;75;368;63;88
20.10.2023 17:00;152;299;35;10;53;38;16;44;;26;;103;36;66;451;45;91
20.10.2023 18:00;140;236;30;14;45;35;18;47;;25;;97;33;79;376;44;80
20.10.2023 19:00;133;227;22;11;38;20;7;37;;17;;53;18;45;360;33;58
20.10.2023 20:00;54;153;16;3;27;14;8;12;;6;;31;10;18;207;19;41
20.10.2023 21:00;71;88;11;4;15;9;2;8;;3;;21;5;12;159;15;24
20.10.2023 22:00;48;83;11;3;16;9;1;9;;4;;22;6;12;131;14;25
20.10.2023 23:00;49;89;2;3;12;9;1;4;;4;;13;2;3;138;5;21
21.10.2023 00:00;21;57;0;0;6;2;3;1;;3;;7;0;8;78;0;8
21.10.2023 01:00;23;39;0;1;5;1;1;2;;1;;7;3;1;62;1;6
21.10.2023 02:00;4;23;0;1;2;0;0;2;;0;;1;0;1;27;1;2
21.10.2023 03:00;2;9;4;0;4;1;0;0;;0;;1;0;0;11;4;5
21.10.2023 04:00;2;8;0;0;2;0;0;2;;0;;1;1;2;10;0;2
21.10.2023 05:00;4;15;0;1;2;3;1;1;;1;;0;2;1;19;1;5
21.10.2023 06:00;16;17;2;0;4;2;0;2;;1;;11;3;5;33;2;6
21.10.2023 07:00;31;41;3;6;21;9;1;3;;1;;13;4;8;72;9;30
21.10.2023 08:00;66;95;13;6;40;26;6;24;;25;;45;15;45;161;19;66
21.10.2023 09:00;136;159;17;10;51;50;12;44;;24;;92;33;53;295;27;101
21.10.2023 10:00;145;186;26;19;69;86;28;71;;30;;162;52;81;331;45;155
21.10.2023 11:00;148;250;53;26;74;93;50;122;;41;;194;82;151;398;79;167
21.10.2023 12:00;188;344;54;28;91;122;45;135;;47;;229;122;202;532;82;213
21.10.2023 13:00;207;367;85;44;124;139;82;177;;65;;283;130;200;574;129;263
21.10.2023 14:00;243;357;76;23;142;140;85;186;;67;;296;136;242;600;99;282
21.10.2023 15:00;202;397;60;49;112;138;83;179;;52;;327;130;238;599;109;250
21.10.2023 16:00;197;352;65;52;101;82;65;167;;47;;233;105;243;549;117;183
21.10.2023 17:00;209;392;61;31;83;90;50;126;;55;;215;99;219;601;92;173
21.10.2023 18:00;226;326;74;21;79;48;23;70;;43;;112;48;167;552;95;127
21.10.2023 19:00;153;232;21;9;31;28;22;38;;23;;88;26;60;385;30;59
21.10.2023 20:00;112;145;8;4;17;10;4;10;;11;;32;5;31;257;12;27
21.10.2023 21:00;63;102;22;1;10;12;2;8;;6;;13;8;19;165;23;22
21.10.2023 22:00;70;88;5;4;10;7;1;7;;5;;15;1;14;158;9;17
21.10.2023 23:00;56;92;3;1;8;6;3;9;;8;;20;1;13;148;4;14
22.10.2023 00:00;51;87;5;1;3;7;0;3;;5;;12;3;12;138;6;10
22.10.2023 01:00;29;62;4;0;0;5;1;6;;1;;9;1;7;91;4;5
22.10.2023 02:00;20;29;0;0;2;3;1;1;;3;;6;1;6;49;0;5
22.10.2023 03:00;15;24;0;0;3;2;1;0;;2;;2;0;3;39;0;5
22.10.2023 04:00;1;11;2;0;1;1;1;2;;1;;3;1;4;12;2;2
22.10.2023 05:00;11;12;2;0;3;3;0;0;;1;;1;0;1;23;2;6
22.10.2023 06:00;11;14;3;2;5;5;0;2;;1;;6;2;7;25;5;10
22.10.2023 07:00;11;13;2;4;5;5;4;6;;2;;9;5;4;24;6;10
22.10.2023 08:00;29;44;17;12;15;15;5;13;;3;;28;23;26;73;29;30
22.10.2023 09:00;64;82;31;12;44;21;20;30;;21;;46;24;49;146;43;65
22.10.2023 10:00;97;111;33;35;40;40;22;78;;32;;82;60;71;208;68;80
22.10.2023 11:00;84;138;41;34;62;58;32;112;;27;;110;90;76;222;75;120
22.10.2023 12:00;101;193;60;22;72;83;32;121;;40;;148;82;96;294;82;155
22.10.2023 13:00;113;192;67;25;85;65;39;116;;46;;152;108;124;305;92;150
22.10.2023 14:00;123;249;47;39;74;69;21;141;;38;;184;113;123;372;86;143
22.10.2023 15:00;168;215;50;23;59;92;45;145;;35;;173;109;123;383;73;151
22.10.2023 16:00;149;219;44;31;77;47;53;126;;30;;149;81;110;368;75;124
22.10.2023 17:00;147;271;42;30;63;77;22;147;;43;;157;94;140;418;72;140
22.10.2023 18:00;145;245;32;10;40;57;17;74;;24;;106;67;83;390;42;97
22.10.2023 19:00;109;153;21;10;36;15;7;21;;6;;48;32;25;262;31;51
22.10.2023 20:00;66;88;11;4;24;8;3;12;;5;;22;14;11;154;15;32
22.10.2023 21:00;50;42;7;0;7;2;1;7;;5;;20;5;4;92;7;9
22.10.2023 22:00;36;60;4;1;11;2;0;6;;4;;4;7;10;96;5;13
22.10.2023 23:00;10;29;0;2;7;1;0;2;;2;;4;2;0;39;2;8
23.10.2023 00:00;5;5;0;0;1;0;0;0;;0;;0;0;1;10;0;1
23.10.2023 01:00;1;2;0;0;1;1;0;3;;0;;1;1;0;3;0;2
23.10.2023 02:00;1;2;0;0;2;1;0;0;;0;;1;0;0;3;0;3
23.10.2023 03:00;1;1;1;0;2;0;0;0;;0;;0;0;0;2;1;2
23.10.2023 04:00;8;10;1;2;3;0;2;0;;0;;3;1;2;18;3;3
23.10.2023 05:00;45;38;19;8;20;10;2;9;;2;;19;5;7;83;27;30
23.10.2023 06:00;111;125;24;42;75;44;20;30;;12;;41;26;48;236;66;119
23.10.2023 07:00;425;364;84;71;179;165;57;107;;61;;218;60;169;789;155;344
23.10.2023 08:00;438;400;61;46;226;199;40;180;;53;;340;62;162;838;107;425
23.10.2023 09:00;236;267;26;23;103;89;24;85;;24;;169;38;89;503;49;192
23.10.2023 10:00;145;215;35;33;54;59;21;67;;28;;109;40;108;360;68;113
23.10.2023 11:00;156;219;32;15;51;51;38;87;;31;;97;54;109;375;47;102
23.10.2023 12:00;142;291;57;22;64;60;40;85;;23;;116;73;84;433;79;124
23.10.2023 13:00;192;344;55;22;96;66;29;92;;46;;156;57;136;536;77;162
23.10.2023 14:00;198;336;56;29;93;71;45;102;;45;;144;68;116;534;85;164
23.10.2023 15:00;271;420;82;26;144;107;49;119;;57;;192;78;175;691;108;251
23.10.2023 16:00;275;567;87;41;174;134;54;128;;67;;242;75;178;842;128;308
23.10.2023 17:00;218;495;65;31;157;107;34;104;;54;;201;64;119;713;96;264
23.10.2023 18:00;176;337;51;26;106;75;31;44;;33;;126;31;77;513;77;181
23.10.2023 19:00;118;235;17;15;48;36;9;33;;22;;54;19;55;353;32;84
23.10.2023 20:00;77;158;14;15;23;17;4;13;;9;;33;6;22;235;29;40
23.10.2023 21:00;57;127;16;1;17;10;2;5;;5;;25;6;11;184;17;27
23.10.2023 22:00;40;70;7;5;17;12;1;8;;5;;11;4;16;110;12;29
23.10.2023 23:00;14;33;1;4;6;3;1;1;;0;;3;1;7;47;5;9
24.10.2023 00:00;5;10;0;0;1;0;0;1;;2;;1;0;0;15;0;1
24.10.2023 01:00;1;10;0;0;0;3;0;1;;0;;1;0;1;11;0;3
24.10.2023 02:00;2;3;3;0;3;0;0;0;;0;;0;0;0;5;3;3
24.10.2023 03:00;2;3;1;0;3;0;0;0;;0;;0;0;0;5;1;3
24.10.2023 04:00;7;6;2;2;1;3;0;0;;0;;4;2;2;13;4;4
24.10.2023 05:00;39;28;10;6;13;8;1;7;;2;;14;4;10;67;16;21
24.10.2023 06:00;123;126;36;34;57;39;18;27;;11;;51;24;48;249;70;96
24.10.2023 07:00;407;388;79;59;187;154;54;117;;54;;216;63;159;795;138;341
24.10.2023 08:00;486;416;83;45;237;221;47;156;;57;;377;74;199;902;128;458
24.10.2023 09:00;229;245;43;11;106;104;25;86;;34;;197;43;91;474;54;210
24.10.2023 10:00;191;197;22;14;57;53;20;63;;22;;76;34;75;388;36;110
24.10.2023 11:00;123;205;31;21;48;48;16;58;;19;;70;43;71;328;52;96
24.10.2023 12:00;133;279;28;12;60;41;23;49;;38;;74;45;78;412;40;101
24.10.2023 13:00;152;273;41;18;70;54;16;46;;24;;89;25;58;425;59;124
24.10.2023 14:00;123;299;41;16;70;60;11;34;;21;;91;22;61;422;57;130
24.10.2023 15:00;149;304;47;9;101;58;13;57;;26;;101;32;63;453;56;159
24.10.2023 16:00;261;487;91;42;188;131;50;128;;50;;232;72;165;748;133;319
24.10.2023 17:00;294;585;91;42;209;160;46;160;;67;;322;101;255;879;133;369
24.10.2023 18:00;280;537;78;48;147;129;49;106;;46;;205;82;182;817;126;276
24.10.2023 19:00;194;354;36;16;77;64;20;49;;31;;102;27;91;548;52;141
24.10.2023 20:00;118;196;16;8;37;24;2;11;;13;;41;10;31;314;24;61
24.10.2023 21:00;93;145;13;3;21;17;0;8;;7;;28;12;30;238;16;38
24.10.2023 22:00;63;151;10;9;22;7;2;8;;3;;26;4;13;214;19;29
24.10.2023 23:00;28;62;3;3;11;2;0;1;;7;;9;0;11;90;6;13
25.10.2023 00:00;6;14;1;0;6;3;0;3;;0;;2;1;3;20;1;9
25.10.2023 01:00;5;9;3;0;1;1;0;0;;0;;0;0;0;14;3;2
25.10.2023 02:00;2;2;0;0;0;0;0;0;;0;;1;0;0;4;0;0
25.10.2023 03:00;1;0;0;0;4;1;0;0;;0;;0;0;0;1;0;5
25.10.2023 04:00;12;4;2;4;3;1;3;0;;1;;2;2;2;16;6;4
25.10.2023 05:00;24;35;12;9;9;7;5;6;;0;;17;5;7;59;21;16
25.10.2023 06:00;107;94;23;21;54;38;23;22;;4;;38;19;32;201;44;92
25.10.2023 07:00;354;321;70;61;168;130;40;110;;48;;186;55;162;675;131;298
25.10.2023 08:00;458;388;54;43;206;196;35;164;;48;;333;70;153;846;97;402
25.10.2023 09:00;193;246;29;8;86;81;17;81;;23;;166;36;77;439;37;167
25.10.2023 10:00;121;193;18;24;54;45;15;39;;18;;66;36;61;314;42;99
25.10.2023 11:00;107;180;19;18;42;34;11;57;;12;;63;40;41;287;37;76
25.10.2023 12:00;96;198;24;4;36;26;19;14;;11;;44;19;28;294;28;62
25.10.2023 13:00;80;194;31;9;38;31;19;31;;15;;49;15;32;274;40;69
25.10.2023 14:00;88;203;24;13;47;30;8;25;;14;;63;20;48;291;37;77
25.10.2023 15:00;105;231;16;15;66;59;12;34;;16;;75;23;42;336;31;125
25.10.2023 16:00;162;421;68;36;130;107;31;70;;39;;150;34;83;583;104;237
25.10.2023 17:00;198;403;40;27;131;117;21;94;;42;;200;53;131;601;67;248
25.10.2023 18:00;163;379;45;15;97;79;21;78;;43;;144;40;106;542;60;176
25.10.2023 19:00;139;245;24;8;45;32;7;20;;17;;61;21;55;384;32;77
25.10.2023 20:00;87;161;13;8;24;13;4;17;;10;;26;11;27;248;21;37
25.10.2023 21:00;77;115;7;3;18;11;4;9;;3;;29;2;17;192;10;29
25.10.2023 22:00;57;110;7;2;11;7;0;4;;7;;14;9;9;167;9;18
25.10.2023 23:00;24;59;3;0;8;4;1;4;;6;;4;0;9;83;3;12
26.10.2023 00:00;9;10;1;1;1;2;0;0;;0;;4;0;1;19;2;3
26.10.2023 01:00;6;8;0;0;0;0;1;1;;0;;1;0;1;14;0;0
26.10.2023 02:00;2;4;1;0;0;1;0;1;;0;;1;0;0;6;1;1
26.10.2023 03:00;4;3;2;0;4;0;0;0;;1;;0;0;0;7;2;4
26.10.2023 04:00;6;6;1;0;5;1;0;0;;0;;1;2;0;12;1;6
26.10.2023 05:00;34;30;14;5;10;9;1;7;;1;;8;1;7;64;19;19
26.10.2023 06:00;92;98;14;32;50;31;16;27;;7;;42;17;32;190;46;81
26.10.2023 07:00;357;317;71;64;144;131;43;99;;52;;172;55;143;674;135;275
26.10.2023 08:00;404;347;54;44;182;195;50;149;;42;;303;55;134;751;98;377
26.10.2023 09:00;203;294;40;18;74;90;16;45;;32;;150;34;71;497;58;164
26.10.2023 10:00;150;200;16;16;44;36;29;65;;22;;79;29;63;350;32;80
26.10.2023 11:00;141;194;30;23;51;41;20;58;;22;;87;46;69;335;53;92
26.10.2023 12:00;126;294;42;16;75;50;23;60;;44;;126;57;83;420;58;125
26.10.2023 13:00;174;328;43;14;77;67;18;60;;36;;149;45;101;502;57;144
26.10.2023 14:00;150;296;35;16;77;58;22;69;;41;;109;42;107;446;51;135
26.10.2023 15:00;183;348;48;21;82;64;22;108;;56;;135;46;99;531;69;146
26.10.2023 16:00;199;406;87;34;130;102;25;86;;52;;179;52;96;605;121;232
26.10.2023 17:00;238;509;78;31;158;134;49;91;;54;;225;57;154;747;109;292
26.10.2023 18:00;211;431;45;19;121;96;34;81;;31;;186;46;113;642;64;217
26.10.2023 19:00;177;334;23;9;37;33;11;25;;18;;82;24;66;511;32;70
26.10.2023 20:00;95;163;16;9;23;25;2;24;;8;;32;18;46;258;25;48
26.10.2023 21:00;91;151;11;1;20;12;1;12;;8;;28;10;23;242;12;32
26.10.2023 22:00;57;146;6;4;19;11;2;5;;6;;16;4;10;203;10;30
26.10.2023 23:00;42;53;0;2;3;6;0;1;;4;;0;1;2;95;2;9
27.10.2023 00:00;5;32;0;2;4;1;0;1;;2;;7;0;7;37;2;5
27.10.2023 01:00;6;12;0;1;0;0;0;0;;0;;0;1;2;18;1;0
27.10.2023 02:00;3;8;5;0;3;0;0;3;;0;;3;2;1;11;5;3
27.10.2023 03:00;4;2;0;0;1;1;2;0;;0;;0;1;0;6;0;2
27.10.2023 04:00;2;11;4;2;3;2;1;0;;0;;0;1;1;13;6;5
27.10.2023 05:00;35;29;6;3;7;8;1;4;;1;;8;3;4;64;9;15
27.10.2023 06:00;73;59;18;12;36;16;17;14;;4;;23;15;17;132;30;52
27.10.2023 07:00;193;186;33;31;65;41;18;40;;21;;73;23;65;379;64;106
27.10.2023 08:00;158;173;36;19;70;57;8;40;;24;;84;15;39;331;55;127
27.10.2023 09:00;90;123;16;5;29;26;6;21;;10;;60;10;19;213;21;55
27.10.2023 10:00;78;113;13;4;16;12;6;10;;11;;31;6;16;191;17;28
27.10.2023 11:00;85;128;12;4;24;18;23;24;;8;;43;17;33;213;16;42
27.10.2023 12:00;94;164;27;14;43;29;7;36;;18;;54;29;51;258;41;72
27.10.2023 13:00;137;265;24;12;42;40;8;53;;35;;86;29;87;402;36;82
27.10.2023 14:00;111;273;42;15;52;54;23;29;;13;;68;29;68;384;57;106
27.10.2023 15:00;131;287;38;26;75;42;29;41;;27;;101;31;72;418;64;117
27.10.2023 16:00;163;259;56;33;74;57;27;75;;32;;122;42;94;422;89;131
27.10.2023 17:00;178;356;40;33;71;64;32;100;;32;;130;64;152;534;73;135
27.10.2023 18:00;169;341;37;20;69;47;14;69;;26;;112;43;106;510;57;116
27.10.2023 19:00;176;286;37;18;55;28;11;39;;19;;68;15;63;462;55;83
27.10.2023 20:00;85;169;12;4;34;15;2;22;;4;;32;7;24;254;16;49
27.10.2023 21:00;74;107;9;7;15;13;0;8;;6;;25;12;19;181;16;28
27.10.2023 22:00;57;119;12;3;15;4;1;8;;5;;16;2;19;176;15;19
27.10.2023 23:00;37;99;12;7;12;8;0;8;;15;;13;0;11;136;19;20
28.10.2023 00:00;26;61;5;0;6;0;1;2;;0;;9;6;8;87;5;6
28.10.2023 01:00;10;41;2;3;8;1;1;3;;2;;5;2;8;51;5;9
28.10.2023 02:00;6;17;1;3;5;0;0;3;;0;;2;0;0;23;4;5
28.10.2023 03:00;3;9;0;0;1;0;0;0;;1;;0;0;0;12;0;1
28.10.2023 04:00;3;4;3;0;2;2;1;2;;0;;2;1;0;7;3;4
28.10.2023 05:00;5;9;3;0;3;1;0;2;;1;;4;1;1;14;3;4
28.10.2023 06:00;17;21;0;3;5;3;1;3;;0;;5;4;4;38;3;8
28.10.2023 07:00;18;33;7;10;5;6;1;6;;0;;10;4;6;51;17;11
28.10.2023 08:00;49;67;16;8;26;36;5;19;;10;;38;9;18;116;24;62
28.10.2023 09:00;80;136;20;3;36;22;2;23;;20;;37;14;44;216;23;58
28.10.2023 10:00;97;121;17;13;22;30;4;35;;23;;33;28;45;218;30;52
28.10.2023 11:00;114;165;24;16;25;43;15;35;;24;;64;27;81;279;40;68
28.10.2023 12:00;145;260;40;24;51;37;25;62;;32;;89;62;100;405;64;88
28.10.2023 13:00;161;259;46;16;63;54;31;78;;25;;104;50;128;420;62;117
28.10.2023 14:00;156;254;37;30;73;49;51;84;;36;;122;55;146;410;67;122
28.10.2023 15:00;138;273;32;21;72;46;45;71;;43;;128;65;119;411;53;118
28.10.2023 16:00;135;292;60;23;59;61;49;98;;41;;151;73;113;427;83;120
28.10.2023 17:00;128;286;43;8;74;49;28;84;;25;;158;84;122;414;51;123
28.10.2023 18:00;146;240;32;10;51;27;17;40;;32;;86;42;68;386;42;78
28.10.2023 19:00;94;194;15;5;24;24;7;29;;12;;30;17;35;288;20;48
28.10.2023 20:00;77;123;7;10;30;17;2;16;;11;;32;9;17;200;17;47
28.10.2023 21:00;36;60;12;2;12;2;1;4;;1;;13;7;6;96;14;14
28.10.2023 22:00;42;111;6;2;13;6;1;13;;2;;12;5;11;153;8;19
28.10.2023 23:00;31;76;3;2;11;4;0;3;;4;;9;0;6;107;5;15
29.10.2023 00:00;27;43;3;1;10;7;0;2;;5;;6;3;4;70;4;17
29.10.2023 01:00;26;54;6;0;9;4;0;3;;2;;9;1;7;80;6;13
29.10.2023 02:00;14;40;3;6;8;1;0;2;;1;;2;3;2;54;9;9
29.10.2023 03:00;3;11;1;2;0;0;0;0;;0;;1;0;0;14;3;0
29.10.2023 04:00;4;1;0;0;0;3;0;0;;0;;4;1;0;5;0;3
29.10.2023 05:00;6;11;0;0;3;2;1;3;;1;;7;2;5;17;0;5
29.10.2023 06:00;11;10;2;4;4;5;0;1;;1;;1;2;5;21;6;9
29.10.2023 07:00;8;12;10;4;4;4;3;11;;3;;19;6;9;20;14;8
29.10.2023 08:00;39;50;10;5;35;25;8;25;;10;;24;33;35;89;15;60
29.10.2023 09:00;51;94;43;25;53;42;21;80;;28;;70;44;95;145;68;95
29.10.2023 10:00;103;145;60;37;75;73;40;123;;27;;146;92;131;248;97;148
29.10.2023 11:00;106;149;58;46;79;66;58;105;;29;;105;105;126;255;104;145
29.10.2023 12:00;133;159;44;27;89;87;41;98;;31;;149;56;97;292;71;176
29.10.2023 13:00;84;188;36;20;77;48;40;120;;36;;140;79;120;272;56;125
29.10.2023 14:00;103;208;34;18;61;50;38;99;;26;;124;79;119;311;52;111
29.10.2023 15:00;159;195;50;24;77;76;55;91;;35;;137;78;148;354;74;153
29.10.2023 16:00;120;201;44;28;63;74;28;107;;31;;121;91;113;321;72;137
29.10.2023 17:00;137;223;37;18;53;48;28;84;;42;;115;58;81;360;55;101
29.10.2023 18:00;109;148;20;6;32;25;10;35;;13;;61;28;47;257;26;57
29.10.2023 19:00;87;129;19;7;22;15;5;17;;8;;27;11;21;216;26;37
29.10.2023 20:00;62;88;5;3;22;21;1;7;;5;;16;10;10;150;8;43
29.10.2023 21:00;58;85;5;4;10;4;0;6;;0;;12;0;11;143;9;14
29.10.2023 22:00;32;34;6;3;11;5;2;3;;3;;10;2;10;66;9;16
29.10.2023 23:00;11;20;0;3;2;4;0;0;;2;;5;0;1;31;3;6
30.10.2023 00:00;1;6;0;0;3;1;0;0;;1;;2;0;0;7;0;4
30.10.2023 01:00;8;10;0;0;2;0;0;1;;0;;0;1;2;18;0;2
30.10.2023 02:00;3;2;1;0;2;0;0;0;;0;;0;0;0;5;1;2
30.10.2023 03:00;2;1;3;0;3;0;1;0;;0;;0;0;0;3;3;3
30.10.2023 04:00;7;16;4;4;4;8;0;0;;0;;0;1;4;23;8;12
30.10.2023 05:00;33;21;12;8;21;11;3;9;;3;;10;9;12;54;20;32
30.10.2023 06:00;135;102;18;31;62;39;22;25;;8;;52;19;38;237;49;101
30.10.2023 07:00;404;358;65;70;174;124;52;119;;63;;226;65;161;762;135;298
30.10.2023 08:00;381;389;66;39;207;203;38;144;;53;;306;54;132;770;105;410
30.10.2023 09:00;237;242;36;9;73;82;21;74;;36;;136;32;90;479;45;155
30.10.2023 10:00;195;224;29;21;65;53;27;74;;22;;112;52;92;419;50;118
30.10.2023 11:00;149;215;43;24;43;55;33;73;;20;;104;50;91;364;67;98
30.10.2023 12:00;145;324;47;13;65;49;26;83;;25;;124;56;90;469;60;114
30.10.2023 13:00;191;365;34;26;67;56;31;75;;43;;158;47;106;556;60;123
30.10.2023 14:00;157;372;52;24;88;69;27;66;;36;;137;50;101;529;76;157
30.10.2023 15:00;201;412;49;20;111;66;35;78;;52;;156;51;104;613;69;177
30.10.2023 16:00;249;486;74;27;152;113;35;110;;52;;180;67;118;735;101;265
30.10.2023 17:00;171;434;38;21;142;87;30;68;;41;;171;38;93;605;59;229
30.10.2023 18:00;136;351;29;20;87;70;19;46;;19;;122;31;77;487;49;157
30.10.2023 19:00;114;254;21;4;44;37;1;27;;14;;60;12;37;368;25;81
30.10.2023 20:00;77;132;10;3;16;11;2;15;;10;;30;7;26;209;13;27
30.10.2023 21:00;64;111;12;3;22;15;1;8;;8;;20;6;21;175;15;37
30.10.2023 22:00;39;95;8;4;11;7;1;8;;5;;12;3;7;134;12;18
30.10.2023 23:00;14;34;3;0;3;1;3;0;;1;;5;0;6;48;3;4
31.10.2023 00:00;8;16;3;0;3;2;0;0;;2;;0;1;1;24;3;5
31.10.2023 01:00;3;7;0;0;4;2;0;0;;0;;2;0;0;10;0;6
31.10.2023 02:00;1;2;0;1;3;0;1;1;;0;;0;1;0;3;1;3
31.10.2023 03:00;3;3;0;0;1;0;0;0;;0;;0;0;0;6;0;1
31.10.2023 04:00;3;6;1;1;1;3;0;1;;0;;1;2;0;9;2;4
31.10.2023 05:00;43;33;16;7;17;11;2;9;;4;;15;6;14;76;23;28
31.10.2023 06:00;114;98;19;27;67;39;17;30;;9;;51;24;37;212;46;106
31.10.2023 07:00;416;349;91;73;184;159;63;115;;59;;236;73;145;765;164;343
31.10.2023 08:00;355;399;79;35;230;219;57;157;;48;;350;67;178;754;114;449
31.10.2023 09:00;229;241;22;20;103;96;22;81;;23;;161;47;88;470;42;199
31.10.2023 10:00;150;224;39;23;59;64;19;50;;38;;110;40;85;374;62;123
31.10.2023 11:00;161;245;37;12;61;54;22;79;;34;;84;60;66;406;49;115
31.10.2023 12:00;160;296;38;18;110;62;30;90;;30;;157;62;73;456;56;172
31.10.2023 13:00;176;357;63;28;96;91;37;118;;56;;181;63;130;533;91;187
31.10.2023 14:00;187;409;73;43;112;100;40;111;;47;;186;71;193;596;116;212
31.10.2023 15:00;238;503;88;47;149;115;44;151;;66;;246;108;186;741;135;264
31.10.2023 16:00;252;548;81;44;197;137;59;136;;82;;241;106;225;800;125;334
31.10.2023 17:00;258;485;61;42;190;120;37;128;;49;;235;73;156;743;103;310
31.10.2023 18:00;169;437;46;14;83;77;13;40;;28;;118;34;84;606;60;160
31.10.2023 19:00;157;305;27;13;54;42;10;36;;22;;71;23;56;462;40;96
31.10.2023 20:00;102;233;13;7;33;24;3;16;;19;;32;11;41;335;20;57
31.10.2023 21:00;69;142;9;2;24;15;7;13;;8;;29;17;20;211;11;39
31.10.2023 22:00;93;140;5;5;21;5;2;7;;3;;22;7;13;233;10;26
31.10.2023 23:00;46;123;5;1;17;5;0;7;;4;;13;1;8;169;6;22
01.11.2023 00:00;50;103;6;0;17;6;0;4;;8;;17;1;7;153;6;23
01.11.2023 01:00;66;91;0;2;3;8;2;4;;1;;10;2;8;157;2;11
01.11.2023 02:00;52;50;3;0;4;6;2;0;;0;;3;4;1;102;3;10
01.11.2023 03:00;45;47;3;0;6;1;0;2;;0;;1;0;1;92;3;7
01.11.2023 04:00;42;18;0;1;4;2;0;2;;1;;2;0;0;60;1;6
01.11.2023 05:00;33;20;4;0;5;3;1;3;;1;;2;1;7;53;4;8
01.11.2023 06:00;15;14;3;2;1;6;0;7;;0;;2;11;6;29;5;7
01.11.2023 07:00;17;15;7;7;7;5;7;6;;2;;21;6;10;32;14;12
01.11.2023 08:00;28;41;11;17;12;15;6;31;;7;;34;27;26;69;28;27
01.11.2023 09:00;51;60;26;10;44;36;12;42;;19;;54;30;57;111;36;80
01.11.2023 10:00;74;151;54;25;58;44;31;89;;19;;83;56;104;225;79;102
01.11.2023 11:00;91;131;36;34;63;40;32;113;;32;;112;96;127;222;70;103
01.11.2023 12:00;118;129;51;30;76;47;60;103;;31;;113;81;134;247;81;123
01.11.2023 13:00;132;173;49;36;79;62;55;159;;36;;168;114;144;305;85;141
01.11.2023 14:00;141;260;49;23;97;66;40;116;;60;;204;105;181;401;72;163
01.11.2023 15:00;138;210;53;26;90;79;67;136;;55;;189;107;184;348;79;169
01.11.2023 16:00;139;185;39;50;74;74;54;127;;39;;162;94;180;324;89;148
01.11.2023 17:00;164;204;32;20;60;51;24;72;;24;;106;62;134;368;52;111
01.11.2023 18:00;94;155;13;8;23;20;11;15;;11;;39;22;33;249;21;43
01.11.2023 19:00;75;99;3;1;12;23;2;13;;11;;32;13;15;174;4;35
01.11.2023 20:00;52;101;4;3;19;15;0;7;;5;;17;14;17;153;7;34
01.11.2023 21:00;57;90;7;3;15;6;3;15;;1;;13;13;12;147;10;21
01.11.2023 22:00;32;60;3;0;10;8;2;1;;5;;7;2;14;92;3;18
01.11.2023 23:00;23;23;0;0;4;4;1;1;;2;;7;0;9;46;0;8
02.11.2023 00:00;10;14;0;0;3;0;0;0;;1;;1;0;0;24;0;3
02.11.2023 01:00;0;3;0;0;1;1;0;0;;0;;1;0;0;3;0;2
02.11.2023 02:00;0;2;1;0;1;0;0;0;;0;;0;0;0;2;1;1
02.11.2023 03:00;0;1;0;0;4;0;0;0;;1;;0;1;0;1;0;4
02.11.2023 04:00;3;3;3;1;2;3;2;1;;0;;2;1;0;6;4;5
02.11.2023 05:00;42;24;10;6;18;10;2;2;;1;;9;0;6;66;16;28
02.11.2023 06:00;83;75;14;20;48;27;9;17;;6;;25;21;20;158;34;75
02.11.2023 07:00;252;233;54;30;103;84;33;51;;31;;114;28;69;485;84;187
02.11.2023 08:00;269;273;31;28;105;126;18;74;;22;;177;35;61;542;59;231
02.11.2023 09:00;143;176;13;15;37;37;14;37;;14;;111;16;37;319;28;74
02.11.2023 10:00;118;136;13;9;30;25;10;28;;12;;50;19;33;254;22;55
02.11.2023 11:00;126;184;10;15;35;20;6;26;;14;;42;26;43;310;25;55
02.11.2023 12:00;126;195;19;10;40;31;12;39;;27;;56;31;41;321;29;71
02.11.2023 13:00;117;264;24;13;52;44;19;37;;22;;64;22;46;381;37;96
02.11.2023 14:00;116;246;30;16;65;38;11;50;;22;;65;38;63;362;46;103
02.11.2023 15:00;132;316;39;23;80;59;16;63;;33;;120;39;70;448;62;139
02.11.2023 16:00;199;436;59;33;109;103;29;82;;44;;178;50;107;635;92;212
02.11.2023 17:00;194;463;48;22;118;81;27;79;;32;;191;43;110;657;70;199
02.11.2023 18:00;196;360;36;26;76;60;10;52;;36;;120;19;76;556;62;136
02.11.2023 19:00;183;297;23;11;45;35;4;23;;29;;56;16;69;480;34;80
02.11.2023 20:00;82;171;21;7;25;25;1;15;;8;;37;5;26;253;28;50
02.11.2023 21:00;86;134;9;2;26;11;3;14;;2;;23;11;20;220;11;37
02.11.2023 22:00;70;136;6;2;11;7;2;5;;11;;17;2;9;206;8;18
02.11.2023 23:00;40;61;2;0;7;1;0;4;;2;;4;1;7;101;2;8
03.11.2023 00:00;10;21;4;1;3;4;0;0;;1;;3;0;3;31;5;7
03.11.2023 01:00;4;7;1;0;1;1;0;1;;0;;3;0;1;11;1;2
03.11.2023 02:00;2;8;0;0;0;0;0;0;;0;;0;0;0;10;0;0
03.11.2023 03:00;2;5;0;0;2;0;0;1;;0;;2;1;0;7;0;2
03.11.2023 04:00;0;8;0;1;4;3;1;1;;0;;3;1;0;8;1;7
03.11.2023 05:00;27;30;13;4;13;15;3;3;;1;;9;2;3;57;17;28
03.11.2023 06:00;94;92;21;28;42;41;15;17;;5;;38;17;23;186;49;83
03.11.2023 07:00;328;311;55;62;134;113;38;86;;47;;139;52;145;639;117;247
03.11.2023 08:00;324;351;48;24;149;151;31;132;;34;;240;44;128;675;72;300
03.11.2023 09:00;204;237;32;17;77;64;24;82;;33;;132;40;82;441;49;141
03.11.2023 10:00;167;226;29;15;49;40;14;57;;26;;81;41;61;393;44;89
03.11.2023 11:00;150;287;32;7;50;62;22;53;;35;;131;49;99;437;39;112
03.11.2023 12:00;221;328;57;38;78;52;31;74;;44;;113;56;126;549;95;130
03.11.2023 13:00;200;425;78;32;83;90;34;102;;66;;163;60;151;625;110;173
03.11.2023 14:00;201;416;58;51;119;96;55;100;;51;;176;99;142;617;109;215
03.11.2023 15:00;217;442;71;33;151;97;51;137;;59;;203;110;168;659;104;248
03.11.2023 16:00;229;460;79;36;154;108;30;130;;68;;221;87;182;689;115;262
03.11.2023 17:00;224;392;63;30;109;93;24;93;;52;;169;64;143;616;93;202
03.11.2023 18:00;189;402;40;16;80;45;16;40;;24;;88;25;79;591;56;125
03.11.2023 19:00;146;295;36;15;37;26;7;29;;13;;57;24;44;441;51;63
03.11.2023 20:00;100;206;8;3;26;19;6;8;;8;;31;8;25;306;11;45
03.11.2023 21:00;79;125;11;1;16;8;2;7;;5;;17;7;19;204;12;24
03.11.2023 22:00;61;143;4;1;24;13;1;6;;2;;23;2;14;204;5;37
03.11.2023 23:00;38;87;6;5;6;5;1;4;;4;;8;3;7;125;11;11
04.11.2023 00:00;29;58;2;3;7;6;0;8;;4;;6;4;10;87;5;13
04.11.2023 01:00;14;37;6;1;9;6;0;0;;1;;6;1;8;51;7;15
04.11.2023 02:00;16;22;2;0;3;1;0;0;;0;;2;0;2;38;2;4
04.11.2023 03:00;2;6;1;3;5;0;0;0;;0;;0;0;1;8;4;5
04.11.2023 04:00;7;2;0;0;1;1;0;0;;0;;1;1;2;9;0;2
04.11.2023 05:00;6;19;4;0;5;3;1;3;;1;;0;0;2;25;4;8
04.11.2023 06:00;14;12;1;2;9;2;0;6;;1;;3;5;5;26;3;11
04.11.2023 07:00;14;31;8;2;10;10;2;11;;6;;14;8;12;45;10;20
04.11.2023 08:00;43;76;9;10;26;24;7;26;;8;;36;13;28;119;19;50
04.11.2023 09:00;90;141;18;16;38;20;12;40;;23;;37;32;60;231;34;58
04.11.2023 10:00;126;185;30;29;27;27;20;58;;39;;71;42;73;311;59;54
04.11.2023 11:00;110;196;30;15;31;29;20;34;;23;;78;37;73;306;45;60
04.11.2023 12:00;104;184;24;12;33;31;4;25;;25;;46;24;51;288;36;64
04.11.2023 13:00;71;172;34;5;21;14;8;16;;9;;38;12;42;243;39;35
04.11.2023 14:00;84;180;22;3;29;12;9;29;;16;;39;16;53;264;25;41
04.11.2023 15:00;79;164;17;8;21;23;7;30;;18;;42;15;40;243;25;44
04.11.2023 16:00;75;136;16;18;17;18;5;33;;18;;44;25;35;211;34;35
04.11.2023 17:00;65;116;12;5;12;11;1;23;;17;;32;13;21;181;17;23
04.11.2023 18:00;66;146;6;6;25;16;4;9;;8;;23;7;20;212;12;41
04.11.2023 19:00;77;127;6;4;8;13;1;13;;13;;16;7;13;204;10;21
04.11.2023 20:00;69;78;3;1;15;18;0;5;;3;;15;6;12;147;4;33
04.11.2023 21:00;43;80;5;2;10;6;0;6;;2;;10;4;7;123;7;16
04.11.2023 22:00;37;55;1;2;9;2;1;2;;2;;9;2;10;92;3;11
04.11.2023 23:00;32;53;2;0;5;8;0;3;;0;;6;5;4;85;2;13
05.11.2023 00:00;20;38;3;0;11;12;0;7;;2;;11;5;7;58;3;23
05.11.2023 01:00;24;35;2;3;10;6;0;4;;1;;4;1;1;59;5;16
05.11.2023 02:00;10;25;1;0;1;1;2;0;;0;;3;1;0;35;1;2
05.11.2023 03:00;1;16;0;0;1;0;0;1;;0;;0;0;1;17;0;1
05.11.2023 04:00;4;6;0;0;3;3;0;0;;3;;2;1;3;10;0;6
05.11.2023 05:00;8;9;2;0;0;4;0;2;;1;;1;2;1;17;2;4
05.11.2023 06:00;4;8;2;1;2;2;0;7;;0;;0;9;3;12;3;4
05.11.2023 07:00;8;10;3;2;2;9;5;6;;1;;7;2;5;18;5;11
05.11.2023 08:00;21;35;13;10;20;14;6;13;;8;;22;13;32;56;23;34
05.11.2023 09:00;49;68;16;10;31;23;1;31;;17;;36;31;44;117;26;54
05.11.2023 10:00;107;114;31;9;40;39;13;65;;24;;79;42;79;221;40;79
05.11.2023 11:00;58;103;26;20;34;46;11;70;;22;;57;77;57;161;46;80
05.11.2023 12:00;93;112;24;11;47;32;19;57;;21;;51;52;54;205;35;79
05.11.2023 13:00;92;130;34;15;40;37;18;64;;19;;99;60;63;222;49;77
05.11.2023 14:00;89;186;38;8;39;45;32;75;;23;;84;70;72;275;46;84
05.11.2023 15:00;85;144;17;18;43;38;24;59;;20;;82;44;61;229;35;81
05.11.2023 16:00;90;153;22;10;51;26;17;46;;25;;79;51;55;243;32;77
05.11.2023 17:00;108;215;9;10;35;34;12;63;;26;;73;37;58;323;19;69
05.11.2023 18:00;80;159;10;6;26;17;2;26;;18;;26;19;28;239;16;43
05.11.2023 19:00;73;135;5;4;15;12;3;9;;7;;24;7;18;208;9;27
05.11.2023 20:00;44;98;3;3;16;9;1;8;;8;;13;8;7;142;6;25
05.11.2023 21:00;39;61;0;0;4;2;0;6;;3;;17;5;9;100;0;6
05.11.2023 22:00;30;28;2;1;8;3;0;2;;4;;3;1;8;58;3;11
05.11.2023 23:00;19;27;1;2;2;0;0;3;;1;;0;1;1;46;3;2
06.11.2023 00:00;4;9;0;0;1;0;0;0;;0;;1;0;1;13;0;1
06.11.2023 01:00;4;6;0;1;0;1;0;0;;0;;0;0;0;10;1;1
06.11.2023 02:00;3;0;0;0;0;0;0;0;;0;;0;2;0;3;0;0
06.11.2023 03:00;2;2;0;0;2;1;0;0;;0;;1;0;0;4;0;3
06.11.2023 04:00;2;12;0;1;4;1;0;0;;0;;3;1;0;14;1;5
06.11.2023 05:00;38;29;11;6;14;10;1;9;;2;;17;6;6;67;17;24
06.11.2023 06:00;130;104;23;39;70;42;24;25;;13;;50;29;44;234;62;112
06.11.2023 07:00;437;380;81;78;183;178;54;119;;56;;251;77;175;817;159;361
06.11.2023 08:00;445;409;56;45;254;249;35;190;;56;;364;55;158;854;101;503
06.11.2023 09:00;236;265;36;25;103;74;20;80;;23;;168;47;79;501;61;177
06.11.2023 10:00;154;252;37;22;51;56;30;75;;45;;100;48;98;406;59;107
06.11.2023 11:00;141;240;45;25;44;56;34;72;;37;;95;56;101;381;70;100
06.11.2023 12:00;160;293;46;10;77;51;19;65;;25;;94;64;82;453;56;128
06.11.2023 13:00;158;318;38;16;65;70;22;73;;42;;119;36;110;476;54;135
06.11.2023 14:00;175;350;53;26;103;63;31;58;;35;;136;40;101;525;79;166
06.11.2023 15:00;211;380;79;41;158;115;34;94;;47;;193;63;157;591;120;273
06.11.2023 16:00;288;636;99;42;200;151;51;141;;75;;270;81;241;924;141;351
06.11.2023 17:00;277;602;55;39;202;153;44;110;;67;;266;84;186;879;94;355
06.11.2023 18:00;196;502;39;23;116;93;25;62;;37;;171;41;119;698;62;209
06.11.2023 19:00;150;291;18;11;65;50;5;33;;30;;66;12;44;441;29;115
06.11.2023 20:00;97;181;18;2;24;27;3;10;;14;;35;12;32;278;20;51
06.11.2023 21:00;71;120;18;4;20;13;1;9;;8;;22;4;14;191;22;33
06.11.2023 22:00;55;82;3;5;16;9;1;12;;5;;16;6;11;137;8;25
06.11.2023 23:00;17;23;4;3;12;8;3;5;;1;;9;2;7;40;7;20
07.11.2023 00:00;4;8;1;1;0;0;1;1;;1;;0;0;0;12;2;0
07.11.2023 01:00;1;2;0;0;2;0;0;0;;1;;1;0;2;3;0;2
07.11.2023 02:00;3;4;0;1;2;0;0;1;;0;;0;2;1;7;1;2
07.11.2023 03:00;3;6;0;0;3;0;0;1;;0;;1;0;0;9;0;3
07.11.2023 04:00;2;9;1;1;4;1;1;0;;2;;3;1;0;11;2;5
07.11.2023 05:00;50;41;11;9;20;6;0;7;;3;;14;4;9;91;20;26
07.11.2023 06:00;146;134;30;46;73;44;21;30;;10;;53;30;40;280;76;117
07.11.2023 07:00;436;378;81;72;185;180;53;135;;60;;241;74;151;814;153;365
07.11.2023 08:00;439;434;74;49;245;246;45;173;;50;;414;61;163;873;123;491
07.11.2023 09:00;234;267;33;22;96;95;22;78;;29;;170;32;85;501;55;191
07.11.2023 10:00;165;208;45;18;45;49;20;65;;23;;84;37;66;373;63;94
07.11.2023 11:00;132;224;42;17;42;39;22;56;;26;;88;44;84;356;59;81
07.11.2023 12:00;161;279;33;21;85;57;17;84;;30;;103;65;74;440;54;142
07.11.2023 13:00;180;352;44;21;81;69;23;51;;34;;127;42;99;532;65;150
07.11.2023 14:00;188;365;62;29;81;89;27;79;;43;;129;43;129;553;91;170
07.11.2023 15:00;187;398;58;14;113;92;26;78;;50;;142;54;86;585;72;205
07.11.2023 16:00;254;503;95;36;190;139;38;94;;54;;229;67;152;757;131;329
07.11.2023 17:00;293;582;72;43;193;156;30;112;;57;;258;74;175;875;115;349
07.11.2023 18:00;240;469;49;30;122;83;28;63;;42;;166;47;105;709;79;205
07.11.2023 19:00;146;285;16;4;64;39;16;23;;21;;60;14;58;431;20;103
07.11.2023 20:00;106;192;11;7;28;18;3;19;;16;;28;19;25;298;18;46
07.11.2023 21:00;85;132;11;3;25;16;4;5;;4;;28;7;25;217;14;41
07.11.2023 22:00;45;100;8;7;29;7;1;10;;5;;8;5;7;145;15;36
07.11.2023 23:00;24;38;1;3;7;2;1;1;;4;;2;1;3;62;4;9
08.11.2023 00:00;8;19;1;1;3;0;0;0;;0;;0;1;4;27;2;3
08.11.2023 01:00;1;5;1;0;2;1;0;0;;0;;0;1;2;6;1;3
08.11.2023 02:00;2;6;0;1;0;0;0;0;;0;;1;1;0;8;1;0
08.11.2023 03:00;1;4;1;0;7;0;1;0;;0;;4;0;0;5;1;7
08.11.2023 04:00;6;8;3;3;5;3;1;0;;0;;2;1;2;14;6;8
08.11.2023 05:00;41;39;6;6;18;10;2;4;;2;;13;2;6;80;12;28
08.11.2023 06:00;124;124;31;35;75;43;21;31;;8;;48;22;37;248;66;118
08.11.2023 07:00;397;354;81;74;189;195;59;123;;55;;236;64;182;751;155;384
08.11.2023 08:00;459;427;68;47;257;240;43;178;;55;;383;71;165;886;115;497
08.11.2023 09:00;219;256;36;25;87;95;15;84;;35;;170;39;88;475;61;182
08.11.2023 10:00;157;236;26;25;48;61;32;59;;29;;82;45;78;393;51;109
08.11.2023 11:00;156;228;38;24;55;48;34;70;;27;;98;51;81;384;62;103
08.11.2023 12:00;161;308;40;16;64;65;36;68;;25;;128;66;100;469;56;129
08.11.2023 13:00;162;336;57;28;114;71;33;85;;41;;135;52;120;498;85;185
08.11.2023 14:00;176;354;46;34;107;91;25;83;;43;;159;61;119;530;80;198
08.11.2023 15:00;206;418;76;24;130;119;36;98;;39;;212;70;129;624;100;249
08.11.2023 16:00;271;551;99;46;189;133;42;114;;67;;222;76;173;822;145;322
08.11.2023 17:00;236;505;70;33;165;126;35;102;;43;;207;65;145;741;103;291
08.11.2023 18:00;161;400;29;14;111;80;16;43;;37;;123;20;88;561;43;191
08.11.2023 19:00;128;252;19;11;49;35;7;26;;17;;67;17;52;380;30;84
08.11.2023 20:00;83;161;12;7;30;14;0;7;;17;;15;7;22;244;19;44
08.11.2023 21:00;76;126;9;7;25;9;0;13;;6;;14;5;14;202;16;34
08.11.2023 22:00;44;65;12;3;13;9;1;8;;1;;11;4;8;109;15;22
08.11.2023 23:00;27;41;0;1;5;3;0;2;;3;;6;2;4;68;1;8
09.11.2023 00:00;4;15;5;3;3;0;0;1;;0;;0;0;1;19;8;3
09.11.2023 01:00;6;8;0;0;2;0;0;1;;0;;1;1;0;14;0;2
09.11.2023 02:00;4;2;0;0;0;0;0;0;;0;;1;0;0;6;0;0
09.11.2023 03:00;4;2;1;0;2;1;1;0;;0;;0;0;0;6;1;3
09.11.2023 04:00;7;7;0;2;6;3;0;0;;0;;2;2;2;14;2;9
09.11.2023 05:00;33;28;5;5;13;7;0;5;;1;;6;1;4;61;10;20
09.11.2023 06:00;85;68;14;23;45;23;16;12;;5;;29;14;21;153;37;68
09.11.2023 07:00;252;215;43;28;96;76;22;44;;28;;105;36;80;467;71;172
09.11.2023 08:00;278;269;45;28;118;162;17;83;;32;;216;15;93;547;73;280
09.11.2023 09:00;163;169;17;14;53;52;9;27;;26;;89;22;52;332;31;105
09.11.2023 10:00;124;147;9;6;29;30;10;27;;20;;54;27;32;271;15;59
09.11.2023 11:00;94;161;10;7;33;32;7;27;;9;;43;13;40;255;17;65
09.11.2023 12:00;115;208;15;15;46;52;12;29;;18;;52;26;67;323;30;98
09.11.2023 13:00;95;199;15;5;33;40;9;32;;23;;60;15;43;294;20;73
09.11.2023 14:00;138;239;36;14;57;48;10;29;;14;;81;27;62;377;50;105
09.11.2023 15:00;170;333;45;13;76;70;29;72;;38;;165;66;97;503;58;146
09.11.2023 16:00;206;395;76;37;115;86;35;85;;53;;170;62;137;601;113;201
09.11.2023 17:00;203;444;62;26;99;89;20;66;;34;;165;46;112;647;88;188
09.11.2023 18:00;197;348;29;21;78;63;15;44;;32;;128;32;73;545;50;141
09.11.2023 19:00;140;257;27;13;46;25;4;25;;41;;55;10;55;397;40;71
09.11.2023 20:00;66;137;13;9;16;11;2;5;;11;;19;2;17;203;22;27
09.11.2023 21:00;84;136;9;4;15;9;3;10;;5;;19;5;14;220;13;24
09.11.2023 22:00;62;116;8;1;26;6;1;7;;4;;22;3;15;178;9;32
09.11.2023 23:00;22;45;5;5;5;5;1;2;;11;;6;1;6;67;10;10
10.11.2023 00:00;10;18;2;0;4;0;0;2;;1;;2;0;3;28;2;4
10.11.2023 01:00;4;12;2;0;0;1;0;0;;0;;2;0;0;16;2;1
10.11.2023 02:00;3;4;0;0;0;0;0;2;;0;;3;0;0;7;0;0
10.11.2023 03:00;0;5;0;0;1;1;0;0;;0;;0;0;0;5;0;2
10.11.2023 04:00;4;12;1;1;4;1;0;0;;0;;1;2;0;16;2;5
10.11.2023 05:00;24;35;6;5;15;7;4;4;;2;;11;2;6;59;11;22
10.11.2023 06:00;95;80;22;21;48;37;10;24;;6;;32;22;22;175;43;85
10.11.2023 07:00;282;286;56;60;124;116;34;70;;50;;157;59;140;568;116;240
10.11.2023 08:00;282;293;50;27;140;127;22;115;;34;;195;27;92;575;77;267
10.11.2023 09:00;213;221;36;21;72;61;13;52;;32;;129;22;78;434;57;133
10.11.2023 10:00;142;197;26;15;41;44;19;54;;33;;88;46;66;339;41;85
10.11.2023 11:00;132;218;36;24;51;53;28;52;;26;;94;43;84;350;60;104
10.11.2023 12:00;154;260;49;16;49;51;15;55;;37;;107;46;78;414;65;100
10.11.2023 13:00;200;344;53;13;64;63;11;36;;39;;116;28;85;544;66;127
10.11.2023 14:00;175;401;57;19;98;67;16;64;;35;;123;49;105;576;76;165
10.11.2023 15:00;195;342;50;28;95;84;37;76;;42;;150;56;84;537;78;179
10.11.2023 16:00;224;422;57;31;104;92;21;80;;52;;173;63;129;646;88;196
10.11.2023 17:00;214;385;39;26;77;74;20;70;;45;;128;65;113;599;65;151
10.11.2023 18:00;167;321;36;10;73;32;11;34;;27;;85;24;71;488;46;105
10.11.2023 19:00;141;277;19;9;23;31;6;14;;13;;41;10;39;418;28;54
10.11.2023 20:00;75;116;15;3;19;11;2;6;;6;;20;6;16;191;18;30
10.11.2023 21:00;61;121;18;1;14;6;1;5;;5;;23;10;15;182;19;20
10.11.2023 22:00;61;106;3;6;12;8;0;8;;4;;14;4;11;167;9;20
10.11.2023 23:00;25;67;7;1;8;4;1;3;;6;;4;2;5;92;8;12
11.11.2023 00:00;13;48;0;0;9;4;0;2;;2;;1;3;3;61;0;13
11.11.2023 01:00;15;33;2;0;1;2;0;0;;1;;4;0;0;48;2;3
11.11.2023 02:00;6;13;0;1;4;1;0;1;;0;;0;2;0;19;1;5
11.11.2023 03:00;2;8;1;0;0;0;0;0;;0;;0;0;1;10;1;0
11.11.2023 04:00;6;2;1;0;1;2;0;0;;0;;2;2;0;8;1;3
11.11.2023 05:00;8;7;0;0;4;2;0;2;;0;;0;1;1;15;0;6
11.11.2023 06:00;6;13;3;2;4;1;3;4;;1;;2;2;2;19;5;5
11.11.2023 07:00;21;27;8;2;12;6;2;7;;2;;6;7;4;48;10;18
11.11.2023 08:00;44;60;16;11;20;22;12;17;;7;;26;17;30;104;27;42
11.11.2023 09:00;104;128;22;11;27;20;16;30;;10;;47;20;49;232;33;47
11.11.2023 10:00;129;193;12;17;39;38;27;44;;40;;65;47;61;322;29;77
11.11.2023 11:00;124;237;39;14;41;43;23;59;;32;;95;46;81;361;53;84
11.11.2023 12:00;137;250;33;15;50;37;27;60;;44;;103;73;109;387;48;87
11.11.2023 13:00;121;261;43;18;52;52;40;92;;44;;101;74;86;382;61;104
11.11.2023 14:00;105;234;23;17;53;32;16;66;;28;;93;63;64;339;40;85
11.11.2023 15:00;84;202;29;17;28;23;25;43;;22;;74;37;53;286;46;51
11.11.2023 16:00;109;219;18;9;54;28;17;41;;19;;73;52;74;328;27;82
11.11.2023 17:00;93;190;17;18;42;25;10;36;;10;;61;29;45;283;35;67
11.11.2023 18:00;94;145;11;9;29;16;2;9;;7;;25;23;29;239;20;45
11.11.2023 19:00;62;133;4;3;18;8;2;15;;9;;19;6;18;195;7;26
11.11.2023 20:00;55;102;7;4;14;5;4;2;;4;;6;0;9;157;11;19
11.11.2023 21:00;40;61;7;3;10;4;0;4;;3;;8;4;17;101;10;14
11.11.2023 22:00;46;64;4;2;7;6;3;2;;5;;12;4;8;110;6;13
11.11.2023 23:00;19;63;1;2;8;5;1;4;;0;;8;0;9;82;3;13
12.11.2023 00:00;28;39;5;0;4;3;0;0;;3;;6;0;2;67;5;7
12.11.2023 01:00;13;26;5;0;4;2;1;3;;2;;3;3;10;39;5;6
12.11.2023 02:00;17;15;8;0;2;4;0;0;;2;;3;0;6;32;8;6
12.11.2023 03:00;5;7;3;0;1;0;0;0;;0;;1;0;0;12;3;1
12.11.2023 04:00;2;3;0;1;0;0;2;3;;0;;2;0;0;5;1;0
12.11.2023 05:00;7;5;4;2;3;0;0;4;;0;;1;3;2;12;6;3
12.11.2023 06:00;7;10;2;0;2;3;0;1;;1;;2;2;6;17;2;5
12.11.2023 07:00;8;11;9;5;9;6;4;11;;0;;12;12;8;19;14;15
12.11.2023 08:00;33;33;17;3;16;9;10;18;;11;;25;18;21;66;20;25
12.11.2023 09:00;58;99;20;20;25;28;13;42;;13;;45;43;52;157;40;53
12.11.2023 10:00;113;129;37;26;78;40;23;92;;34;;106;57;86;242;63;118
12.11.2023 11:00;110;179;63;23;51;77;45;117;;37;;136;91;127;289;86;128
12.11.2023 12:00;162;218;94;46;109;88;51;133;;51;;187;87;204;380;140;197
12.11.2023 13:00;143;271;89;48;111;88;67;145;;58;;186;126;196;414;137;199
12.11.2023 14:00;179;278;73;60;100;106;80;191;;59;;225;122;249;457;133;206
12.11.2023 15:00;175;243;63;44;110;88;51;99;;41;;180;55;168;418;107;198
12.11.2023 16:00;178;213;51;35;69;59;44;79;;61;;126;68;129;391;86;128
12.11.2023 17:00;133;260;34;25;35;48;20;44;;34;;92;50;86;393;59;83
12.11.2023 18:00;87;140;14;5;26;13;5;23;;12;;27;16;26;227;19;39
12.11.2023 19:00;88;129;12;8;29;13;7;19;;11;;22;10;23;217;20;42
12.11.2023 20:00;53;84;7;5;12;8;2;8;;3;;15;10;9;137;12;20
12.11.2023 21:00;32;55;13;1;11;4;0;9;;3;;12;3;9;87;14;15
12.11.2023 22:00;17;47;8;1;5;2;2;4;;3;;5;2;2;64;9;7
12.11.2023 23:00;11;22;4;0;5;0;0;1;;1;;3;0;0;33;4;5
13.11.2023 00:00;3;3;1;0;5;0;0;0;;0;;0;0;0;6;1;5
13.11.2023 01:00;5;11;0;0;0;0;0;0;;0;;2;0;0;16;0;0
13.11.2023 02:00;0;5;1;0;0;0;0;0;;0;;1;0;0;5;1;0
13.11.2023 03:00;4;1;0;0;0;0;0;0;;0;;0;0;0;5;0;0
13.11.2023 04:00;4;7;2;1;7;2;0;0;;0;;2;3;2;11;3;9
13.11.2023 05:00;35;34;8;5;15;4;1;4;;0;;15;1;6;69;13;19
13.11.2023 06:00;97;91;24;26;60;33;16;21;;10;;35;18;30;188;50;93
13.11.2023 07:00;295;262;57;47;119;129;31;59;;42;;145;39;106;557;104;248
13.11.2023 08:00;256;278;43;34;116;126;15;62;;26;;186;29;77;534;77;242
13.11.2023 09:00;103;140;21;5;41;29;9;20;;8;;62;6;20;243;26;70
13.11.2023 10:00;63;89;9;3;16;18;2;4;;13;;22;10;22;152;12;34
13.11.2023 11:00;71;103;12;11;22;17;3;20;;13;;28;13;19;174;23;39
13.11.2023 12:00;95;157;25;6;28;37;11;23;;16;;45;16;39;252;31;65
13.11.2023 13:00;115;207;19;10;44;30;6;23;;22;;64;15;48;322;29;74
13.11.2023 14:00;115;202;23;9;40;44;7;32;;20;;52;15;40;317;32;84
13.11.2023 15:00;148;268;34;8;60;56;17;34;;34;;86;20;67;416;42;116
13.11.2023 16:00;173;374;60;38;112;75;34;45;;45;;118;42;92;547;98;187
13.11.2023 17:00;154;337;32;25;103;71;14;39;;29;;112;27;77;491;57;174
13.11.2023 18:00;168;347;39;16;77;46;9;28;;28;;102;26;71;515;55;123
13.11.2023 19:00;134;214;17;9;34;27;6;16;;20;;44;6;26;348;26;61
13.11.2023 20:00;63;144;10;5;29;19;3;11;;8;;35;6;18;207;15;48
13.11.2023 21:00;56;91;10;3;7;9;0;9;;12;;20;9;11;147;13;16
13.11.2023 22:00;54;97;10;5;11;7;2;8;;7;;6;4;4;151;15;18
13.11.2023 23:00;25;33;2;1;7;2;0;0;;0;;4;1;4;58;3;9
14.11.2023 00:00;6;6;0;0;1;2;1;0;;0;;0;0;0;12;0;3
14.11.2023 01:00;3;4;2;0;2;2;0;0;;1;;0;0;1;7;2;4
14.11.2023 02:00;1;3;0;0;0;1;0;1;;0;;1;0;0;4;0;1
14.11.2023 03:00;4;3;0;0;1;1;0;0;;0;;0;0;0;7;0;2
14.11.2023 04:00;5;9;1;1;9;1;0;1;;0;;0;4;2;14;2;10
14.11.2023 05:00;36;34;12;5;21;9;1;4;;1;;12;2;4;70;17;30
14.11.2023 06:00;119;122;27;35;62;34;14;21;;9;;41;19;35;241;62;96
14.11.2023 07:00;356;310;70;64;149;141;39;106;;47;;195;52;135;666;134;290
14.11.2023 08:00;412;389;56;38;190;218;39;160;;40;;312;58;138;801;94;408
14.11.2023 09:00;210;233;37;16;78;71;15;63;;26;;137;34;69;443;53;149
14.11.2023 10:00;153;170;25;11;44;34;14;46;;29;;63;42;54;323;36;78
14.11.2023 11:00;130;200;23;12;35;48;12;48;;26;;59;36;69;330;35;83
14.11.2023 12:00;116;200;27;16;38;42;12;42;;16;;55;25;40;316;43;80
14.11.2023 13:00;146;271;32;12;68;59;9;53;;32;;81;30;61;417;44;127
14.11.2023 14:00;139;335;41;17;68;66;15;52;;32;;102;27;83;474;58;134
14.11.2023 15:00;166;344;51;14;104;72;21;80;;31;;140;44;91;510;65;176
14.11.2023 16:00;190;394;60;37;160;102;32;75;;48;;167;38;85;584;97;262
14.11.2023 17:00;145;396;53;12;116;67;20;57;;37;;155;21;71;541;65;183
14.11.2023 18:00;157;335;34;12;82;61;15;29;;26;;88;20;65;492;46;143
14.11.2023 19:00;133;250;17;8;54;26;3;19;;21;;50;11;41;383;25;80
14.11.2023 20:00;73;133;2;7;21;20;3;17;;3;;19;9;12;206;9;41
14.11.2023 21:00;72;120;7;1;12;7;1;6;;3;;17;8;13;192;8;19
14.11.2023 22:00;35;70;5;8;11;7;1;3;;1;;8;0;3;105;13;18
14.11.2023 23:00;11;28;3;2;5;4;0;0;;2;;1;0;4;39;5;9
15.11.2023 00:00;8;10;1;1;2;2;0;0;;0;;0;0;1;18;2;4
15.11.2023 01:00;6;4;0;0;0;1;0;1;;0;;1;0;0;10;0;1
15.11.2023 02:00;2;1;0;0;0;0;0;0;;0;;0;0;0;3;0;0
15.11.2023 03:00;0;2;0;0;1;0;0;0;;2;;1;0;0;2;0;1
15.11.2023 04:00;3;8;0;2;3;3;0;0;;0;;0;1;0;11;2;6
15.11.2023 05:00;33;37;9;4;20;8;2;5;;3;;10;5;6;70;13;28
15.11.2023 06:00;101;101;20;33;64;35;18;27;;6;;44;22;30;202;53;99
15.11.2023 07:00;345;312;61;57;190;158;45;105;;44;;189;58;136;657;118;348
15.11.2023 08:00;426;365;46;46;196;198;37;143;;37;;321;58;127;791;92;394
15.11.2023 09:00;196;258;32;28;84;81;21;66;;34;;166;43;84;454;60;165
15.11.2023 10:00;141;197;20;17;49;44;16;55;;19;;85;42;71;338;37;93
15.11.2023 11:00;168;217;32;22;46;49;21;52;;21;;91;48;78;385;54;95
15.11.2023 12:00;157;311;47;22;78;65;28;71;;33;;95;47;89;468;69;143
15.11.2023 13:00;155;338;62;19;89;81;23;62;;37;;128;38;103;493;81;170
15.11.2023 14:00;167;324;42;28;94;71;36;80;;36;;118;65;125;491;70;165
15.11.2023 15:00;207;414;59;36;132;99;40;109;;39;;175;62;118;621;95;231
15.11.2023 16:00;301;481;97;47;171;139;55;136;;55;;208;85;192;782;144;310
15.11.2023 17:00;257;505;60;40;145;131;38;95;;41;;252;71;157;762;100;276
15.11.2023 18:00;206;453;45;36;117;83;23;63;;32;;166;37;92;659;81;200
15.11.2023 19:00;161;296;27;11;65;46;11;33;;23;;99;23;61;457;38;111
15.11.2023 20:00;101;173;15;9;36;29;0;17;;11;;42;6;29;274;24;65
15.11.2023 21:00;85;176;17;6;30;25;1;8;;6;;52;3;21;261;23;55
15.11.2023 22:00;64;104;8;6;21;12;6;10;;5;;26;5;19;168;14;33
15.11.2023 23:00;22;65;5;2;5;7;0;0;;3;;8;2;4;87;7;12
16.11.2023 00:00;8;23;2;0;4;3;0;0;;4;;5;0;2;31;2;7
16.11.2023 01:00;3;3;0;0;3;1;1;0;;1;;4;0;3;6;0;4
16.11.2023 02:00;3;2;0;0;0;0;0;1;;0;;0;1;0;5;0;0
16.11.2023 03:00;1;2;0;0;1;0;0;0;;0;;0;0;1;3;0;1
16.11.2023 04:00;2;8;0;1;2;3;0;0;;0;;0;2;0;10;1;5
16.11.2023 05:00;40;31;7;7;19;7;2;5;;4;;9;5;5;71;14;26
16.11.2023 06:00;112;102;27;34;53;33;8;25;;7;;40;15;31;214;61;86
16.11.2023 07:00;375;329;70;67;181;169;56;114;;60;;223;61;171;704;137;350
16.11.2023 08:00;383;387;75;42;211;211;48;166;;48;;358;62;156;770;117;422
16.11.2023 09:00;222;270;32;18;84;79;11;72;;27;;177;31;89;492;50;163
16.11.2023 10:00;160;204;25;26;56;34;11;62;;21;;80;50;58;364;51;90
16.11.2023 11:00;115;216;27;25;46;43;7;62;;24;;90;43;95;331;52;89
16.11.2023 12:00;161;275;36;22;62;44;10;52;;20;;95;36;83;436;58;106
16.11.2023 13:00;170;310;51;5;87;64;11;60;;34;;124;49;80;480;56;151
16.11.2023 14:00;151;286;29;19;84;59;8;46;;23;;111;24;73;437;48;143
16.11.2023 15:00;201;335;52;31;119;100;6;60;;44;;117;34;95;536;83;219
16.11.2023 16:00;191;514;85;33;126;105;21;102;;38;;201;68;113;705;118;231
16.11.2023 17:00;232;480;48;27;135;114;1;84;;43;;209;46;131;712;75;249
16.11.2023 18:00;199;439;44;31;101;85;2;61;;39;;150;44;79;638;75;186
16.11.2023 19:00;151;327;20;11;60;31;4;23;;22;;65;23;67;478;31;91
16.11.2023 20:00;103;175;16;4;30;21;4;8;;12;;26;4;22;278;20;51
16.11.2023 21:00;63;128;9;5;21;17;0;5;;11;;23;1;20;191;14;38
16.11.2023 22:00;84;98;11;1;13;11;0;4;;9;;17;2;15;182;12;24
16.11.2023 23:00;37;49;2;1;7;3;0;3;;1;;12;0;8;86;3;10
17.11.2023 00:00;4;25;0;0;9;1;0;4;;1;;6;2;1;29;0;10
17.11.2023 01:00;2;12;2;0;3;1;0;1;;0;;2;0;2;14;2;4
17.11.2023 02:00;3;7;0;2;1;0;0;0;;0;;2;0;0;10;2;1
17.11.2023 03:00;2;3;0;1;3;0;0;1;;0;;0;1;0;5;1;3
17.11.2023 04:00;2;8;0;1;3;1;0;1;;0;;0;2;0;10;1;4
17.11.2023 05:00;28;30;7;4;7;11;0;6;;1;;5;5;3;58;11;18
17.11.2023 06:00;86;91;15;24;45;35;10;20;;8;;26;6;23;177;39;80
17.11.2023 07:00;298;277;53;68;116;118;6;68;;50;;127;25;133;575;121;234
17.11.2023 08:00;287;274;45;17;108;124;10;101;;40;;201;19;104;561;62;232
17.11.2023 09:00;172;186;32;17;66;59;5;56;;19;;107;6;50;358;49;125
17.11.2023 10:00;113;167;12;14;23;19;9;37;;25;;53;1;31;280;26;42
17.11.2023 11:00;90;165;17;5;15;16;0;13;;8;;31;1;33;255;22;31
17.11.2023 12:00;105;175;25;10;55;24;0;15;;16;;47;0;23;280;35;79
17.11.2023 13:00;161;274;45;11;55;49;1;18;;29;;54;1;58;435;56;104
17.11.2023 14:00;134;274;38;18;86;65;5;23;;24;;75;0;63;408;56;151
17.11.2023 15:00;141;295;41;20;68;66;13;55;;27;;101;0;72;436;61;134
17.11.2023 16:00;184;324;45;39;87;58;8;61;;41;;122;0;106;508;84;145
17.11.2023 17:00;161;361;46;21;72;48;2;53;;30;;106;0;98;522;67;120
17.11.2023 18:00;141;279;25;16;68;36;0;29;;23;;64;0;52;420;41;104
17.11.2023 19:00;115;205;25;10;26;24;0;18;;9;;27;0;40;320;35;50
17.11.2023 20:00;73;156;10;1;18;17;0;4;;9;;13;0;18;229;11;35
17.11.2023 21:00;71;101;7;9;17;12;0;12;;2;;16;0;18;172;16;29
17.11.2023 22:00;51;86;3;5;9;13;0;6;;1;;11;0;15;137;8;22
17.11.2023 23:00;25;100;7;2;10;7;0;3;;1;;6;0;9;125;9;17
18.11.2023 00:00;15;59;6;1;6;4;0;0;;2;;3;0;7;74;7;10
18.11.2023 01:00;15;28;1;1;4;2;0;0;;1;;3;0;5;43;2;6
18.11.2023 02:00;7;18;0;0;2;1;0;0;;0;;2;0;1;25;0;3
18.11.2023 03:00;10;14;0;1;1;1;0;0;;2;;1;0;3;24;1;2
18.11.2023 04:00;4;9;0;2;0;1;0;1;;0;;0;0;1;13;2;1
18.11.2023 05:00;8;9;1;0;7;5;0;2;;0;;3;0;0;17;1;12
18.11.2023 06:00;14;11;2;3;1;6;0;4;;1;;5;0;8;25;5;7
18.11.2023 07:00;13;24;3;0;11;9;0;7;;3;;6;0;6;37;3;20
18.11.2023 08:00;50;74;12;6;22;13;0;16;;7;;32;0;20;124;18;35
18.11.2023 09:00;109;118;19;10;36;30;2;20;;23;;39;0;49;227;29;66
18.11.2023 10:00;121;149;40;14;29;36;1;39;;24;;49;0;65;270;54;65
18.11.2023 11:00;137;199;20;11;38;38;0;42;;29;;63;0;83;336;31;76
18.11.2023 12:00;116;238;32;12;50;30;0;21;;18;;57;0;81;354;44;80
18.11.2023 13:00;98;194;19;16;28;15;0;21;;14;;49;0;45;292;35;43
18.11.2023 14:00;80;173;12;11;20;36;0;38;;17;;44;0;43;253;23;56
18.11.2023 15:00;79;157;11;6;30;12;0;20;;11;;37;0;27;236;17;42
18.11.2023 16:00;73;139;13;10;17;13;0;16;;10;;30;0;16;212;23;30
18.11.2023 17:00;47;112;6;0;18;11;0;3;;5;;15;0;10;159;6;29
18.11.2023 18:00;54;126;6;3;14;9;0;2;;6;;12;0;7;180;9;23
18.11.2023 19:00;63;102;6;2;9;4;0;3;;2;;14;0;13;165;8;13
18.11.2023 20:00;49;59;8;0;7;6;0;3;;2;;5;0;9;108;8;13
18.11.2023 21:00;35;57;4;4;6;7;0;1;;4;;12;0;7;92;8;13
18.11.2023 22:00;38;54;1;2;6;1;0;1;;3;;16;0;6;92;3;7
18.11.2023 23:00;16;41;0;3;5;3;0;2;;2;;2;0;10;57;3;8
19.11.2023 00:00;19;33;0;0;6;5;0;4;;0;;3;0;3;52;0;11
19.11.2023 01:00;20;36;3;1;2;3;0;0;;1;;3;0;1;56;4;5
19.11.2023 02:00;14;27;0;1;2;0;0;1;;0;;2;0;3;41;1;2
19.11.2023 03:00;2;18;4;0;2;1;0;4;;1;;3;0;2;20;4;3
19.11.2023 04:00;4;4;2;1;0;0;0;0;;1;;0;0;0;8;3;0
19.11.2023 05:00;3;4;2;0;1;0;0;0;;1;;2;0;0;7;2;1
19.11.2023 06:00;8;13;2;4;5;4;0;4;;2;;3;0;3;21;6;9
19.11.2023 07:00;6;13;5;1;5;5;0;2;;1;;10;0;6;19;6;10
19.11.2023 08:00;34;36;13;5;14;14;0;16;;5;;26;0;20;70;18;28
19.11.2023 09:00;71;89;25;15;47;21;0;36;;20;;38;0;63;160;40;68
19.11.2023 10:00;104;138;62;29;77;72;0;106;;29;;106;0;97;242;91;149
19.11.2023 11:00;107;182;78;49;82;107;0;157;;37;;183;0;159;289;127;189
19.11.2023 12:00;157;188;89;57;109;124;0;157;;34;;212;0;202;345;146;233
19.11.2023 13:00;133;166;86;35;97;81;0;95;;35;;148;0;149;299;121;178
19.11.2023 14:00;127;192;58;22;62;72;0;62;;44;;152;0;129;319;80;134
19.11.2023 15:00;151;215;74;42;70;86;0;108;;69;;143;0;192;366;116;156
19.11.2023 16:00;166;193;54;31;51;62;0;99;;65;;123;0;132;359;85;113
19.11.2023 17:00;102;170;26;16;32;31;0;47;;37;;72;0;65;272;42;63
19.11.2023 18:00;105;145;13;6;20;29;0;9;;5;;32;0;34;250;19;49
19.11.2023 19:00;63;106;6;4;9;15;0;4;;7;;18;0;14;169;10;24
19.11.2023 20:00;54;94;9;2;8;3;0;6;;5;;22;0;14;148;11;11
19.11.2023 21:00;31;65;5;0;9;4;0;12;;2;;6;0;9;96;5;13
19.11.2023 22:00;28;60;4;0;5;4;0;1;;2;;2;0;5;88;4;9
19.11.2023 23:00;8;23;1;0;3;1;0;0;;2;;1;0;1;31;1;4
20.11.2023 00:00;5;11;0;0;0;0;0;0;;0;;0;0;2;16;0;0
20.11.2023 01:00;3;6;0;0;1;0;0;0;;0;;2;0;0;9;0;1
20.11.2023 02:00;1;2;0;0;0;0;0;0;;0;;0;0;0;3;0;0
20.11.2023 03:00;2;3;0;2;1;0;0;0;;0;;0;0;0;5;2;1
20.11.2023 04:00;3;7;1;1;4;1;0;0;;0;;1;0;0;10;2;5
20.11.2023 05:00;37;30;13;5;16;6;0;2;;1;;7;0;3;67;18;22
20.11.2023 06:00;116;112;42;37;67;32;0;11;;6;;38;0;33;228;79;99
20.11.2023 07:00;334;309;83;89;146;154;0;54;;54;;153;0;152;643;172;300
20.11.2023 08:00;422;374;67;40;201;195;0;120;;35;;275;0;121;796;107;396
20.11.2023 09:00;217;231;44;15;76;77;0;54;;28;;148;0;78;448;59;153
20.11.2023 10:00;158;191;29;20;41;41;0;40;;23;;89;0;77;349;49;82
20.11.2023 11:00;146;225;32;17;53;36;0;41;;19;;76;0;85;371;49;89
20.11.2023 12:00;127;253;30;13;44;40;0;42;;29;;72;0;74;380;43;84
20.11.2023 13:00;138;257;43;8;50;62;0;45;;36;;84;0;86;395;51;112
20.11.2023 14:00;161;284;36;23;64;58;0;41;;28;;90;0;60;445;59;122
20.11.2023 15:00;197;348;70;17;110;96;0;79;;55;;150;0;119;545;87;206
20.11.2023 16:00;273;502;77;48;132;126;0;96;;60;;202;0;167;775;125;258
20.11.2023 17:00;211;492;51;46;122;86;0;54;;54;;180;0;139;703;97;208
20.11.2023 18:00;169;417;36;14;100;67;0;16;;27;;105;0;82;586;50;167
20.11.2023 19:00;114;231;14;9;43;31;0;20;;22;;55;0;40;345;23;74
20.11.2023 20:00;66;145;15;2;31;15;0;9;;8;;13;0;13;211;17;46
20.11.2023 21:00;60;92;13;0;17;9;0;1;;2;;26;0;11;152;13;26
20.11.2023 22:00;39;103;3;2;11;6;0;9;;1;;8;0;12;142;5;17
20.11.2023 23:00;15;26;3;0;3;4;0;0;;1;;1;0;1;41;3;7
21.11.2023 00:00;3;11;0;0;2;0;0;0;;0;;0;0;0;14;0;2
21.11.2023 01:00;0;6;0;0;0;2;0;0;;0;;0;0;0;6;0;2
21.11.2023 02:00;4;6;0;0;0;0;0;1;;0;;0;0;0;10;0;0
21.11.2023 03:00;1;1;0;1;2;0;0;0;;0;;0;0;0;2;1;2
21.11.2023 04:00;4;5;2;0;2;1;0;0;;0;;1;0;0;9;2;3
21.11.2023 05:00;46;35;8;5;24;12;0;6;;1;;11;0;7;81;13;36
21.11.2023 06:00;114;125;34;32;52;43;0;9;;11;;44;0;30;239;66;95
21.11.2023 07:00;382;357;81;94;162;156;0;74;;44;;168;0;142;739;175;318
21.11.2023 08:00;401;389;69;52;206;226;0;127;;48;;320;0;159;790;121;432
21.11.2023 09:00;222;232;28;16;81;66;0;57;;20;;132;0;72;454;44;147
21.11.2023 10:00;127;168;22;15;26;39;0;36;;17;;37;0;74;295;37;65
21.11.2023 11:00;104;168;32;19;22;41;0;34;;23;;67;0;71;272;51;63
21.11.2023 12:00;130;216;29;14;59;48;0;42;;30;;70;0;67;346;43;107
21.11.2023 13:00;139;291;48;8;70;64;0;41;;37;;81;0;79;430;56;134
21.11.2023 14:00;138;351;47;23;58;67;0;64;;24;;117;0;86;489;70;125
21.11.2023 15:00;194;389;70;21;110;102;0;54;;44;;148;0;120;583;91;212
21.11.2023 16:00;216;467;92;39;170;125;0;78;;43;;183;0;114;683;131;295
21.11.2023 17:00;229;499;81;46;150;113;0;55;;50;;225;0;131;728;127;263
21.11.2023 18:00;209;424;49;23;114;87;0;31;;34;;125;0;81;633;72;201
21.11.2023 19:00;163;251;14;8;63;35;0;29;;25;;59;0;54;414;22;98
21.11.2023 20:00;93;204;14;7;23;16;0;11;;5;;29;0;23;297;21;39
21.11.2023 21:00;101;144;11;2;26;13;0;11;;4;;28;0;28;245;13;39
21.11.2023 22:00;61;118;7;5;18;5;0;2;;6;;11;0;7;179;12;23
21.11.2023 23:00;27;42;3;4;6;4;0;1;;2;;0;0;9;69;7;10
22.11.2023 00:00;12;14;1;3;5;1;0;0;;0;;3;0;0;26;4;6
22.11.2023 01:00;1;8;0;0;0;0;0;1;;1;;0;0;1;9;0;0
22.11.2023 02:00;2;1;0;0;1;0;0;0;;0;;0;0;0;3;0;1
22.11.2023 03:00;2;4;0;1;1;0;0;0;;0;;0;0;1;6;1;1
22.11.2023 04:00;6;5;3;1;3;1;0;0;;0;;3;0;2;11;4;4
22.11.2023 05:00;38;36;6;5;20;8;0;2;;2;;11;0;8;74;11;28
22.11.2023 06:00;106;100;30;29;70;45;0;16;;10;;33;0;30;206;59;115
22.11.2023 07:00;359;345;69;73;171;164;0;75;;38;;169;0;170;704;142;335
22.11.2023 08:00;408;390;70;53;232;239;0;147;;60;;335;0;157;798;123;471
22.11.2023 09:00;243;239;23;23;88;80;0;61;;16;;146;0;83;482;46;168
22.11.2023 10:00;140;193;30;18;60;38;0;49;;22;;68;0;69;333;48;98
22.11.2023 11:00;139;223;22;20;45;60;0;59;;18;;83;0;86;362;42;105
22.11.2023 12:00;144;285;48;31;68;58;0;45;;34;;100;0;115;429;79;126
22.11.2023 13:00;160;331;60;21;92;58;0;66;;39;;113;0;124;491;81;150
22.11.2023 14:00;178;338;54;35;88;91;0;62;;28;;143;0;120;516;89;179
22.11.2023 15:00;194;416;68;27;115;127;0;91;;60;;161;0;175;610;95;242
22.11.2023 16:00;251;522;97;51;161;142;0;92;;69;;214;0;162;773;148;303
22.11.2023 17:00;268;550;56;37;148;146;0;83;;49;;206;0;163;818;93;294
22.11.2023 18:00;207;418;55;26;112;83;0;43;;44;;154;0;96;625;81;195
22.11.2023 19:00;156;260;25;13;57;29;0;15;;23;;67;0;54;416;38;86
22.11.2023 20:00;111;201;21;7;34;18;0;10;;11;;50;0;41;312;28;52
22.11.2023 21:00;83;157;17;1;23;10;0;4;;8;;33;0;22;240;18;33
22.11.2023 22:00;68;123;7;8;13;12;0;5;;5;;17;0;12;191;15;25
22.11.2023 23:00;31;51;3;1;12;2;0;3;;1;;9;0;1;82;4;14
23.11.2023 00:00;7;14;2;0;1;2;0;0;;0;;0;0;4;21;2;3
23.11.2023 01:00;1;10;0;0;1;1;0;0;;1;;2;0;3;11;0;2
23.11.2023 02:00;1;3;0;0;0;0;0;0;;0;;0;0;0;4;0;0
23.11.2023 03:00;3;3;0;1;1;0;0;0;;0;;0;0;0;6;1;1
23.11.2023 04:00;7;5;1;0;5;1;0;0;;1;;0;0;3;12;1;6
23.11.2023 05:00;50;37;9;10;21;11;0;4;;3;;12;0;11;87;19;32
23.11.2023 06:00;106;102;31;36;48;39;0;16;;8;;38;0;27;208;67;87
23.11.2023 07:00;401;313;83;67;159;151;2;98;;47;;193;0;174;714;150;310
23.11.2023 08:00;397;397;64;71;207;216;6;125;;59;;306;0;162;794;135;423
23.11.2023 09:00;180;261;27;12;88;80;2;73;;21;;127;0;71;441;39;168
23.11.2023 10:00;131;175;21;14;48;33;3;39;;22;;78;0;53;306;35;81
23.11.2023 11:00;139;217;20;17;47;41;2;51;;21;;77;0;64;356;37;88
23.11.2023 12:00;124;272;22;15;77;39;0;56;;18;;102;0;67;396;37;116
23.11.2023 13:00;133;340;43;13;80;58;1;49;;39;;106;0;90;473;56;138
23.11.2023 14:00;169;318;42;30;101;59;2;63;;28;;122;0;79;487;72;160
23.11.2023 15:00;198;415;65;25;142;97;2;64;;45;;175;0;127;613;90;239
23.11.2023 16:00;262;521;92;45;161;135;4;68;;51;;200;0;136;783;137;296
23.11.2023 17:00;227;509;63;28;131;114;0;59;;58;;191;0;143;736;91;245
23.11.2023 18:00;191;436;39;22;105;85;0;49;;28;;145;0;87;627;61;190
23.11.2023 19:00;169;337;24;8;47;47;0;15;;31;;72;0;64;506;32;94
23.11.2023 20:00;85;172;13;9;33;17;2;12;;18;;28;0;26;257;22;50
23.11.2023 21:00;83;160;13;3;15;13;0;14;;7;;20;0;14;243;16;28
23.11.2023 22:00;72;123;7;4;10;11;0;2;;6;;14;0;19;195;11;21
23.11.2023 23:00;51;72;1;1;12;1;0;8;;5;;13;0;10;123;2;13
24.11.2023 00:00;14;20;3;0;1;2;0;2;;1;;4;0;1;34;3;3
24.11.2023 01:00;1;7;1;0;2;0;0;2;;0;;1;0;0;8;1;2
24.11.2023 02:00;5;1;0;0;0;1;0;0;;0;;1;0;0;6;0;1
24.11.2023 03:00;3;3;0;1;3;0;0;0;;0;;0;0;0;6;1;3
24.11.2023 04:00;3;6;0;0;3;0;0;0;;0;;1;0;0;9;0;3
24.11.2023 05:00;28;30;8;4;16;7;0;2;;2;;7;0;5;58;12;23
24.11.2023 06:00;77;77;20;23;31;31;0;9;;7;;21;0;20;154;43;62
24.11.2023 07:00;281;236;53;77;92;106;1;55;;30;;119;14;97;517;130;198
24.11.2023 08:00;234;293;38;22;115;109;2;86;;32;;146;9;81;527;60;224
24.11.2023 09:00;110;129;18;9;31;37;0;13;;14;;56;1;30;239;27;68
24.11.2023 10:00;88;144;14;6;28;32;0;21;;7;;45;9;28;232;20;60
24.11.2023 11:00;93;144;11;11;23;25;0;19;;17;;29;17;30;237;22;48
24.11.2023 12:00;107;202;30;10;28;24;0;26;;20;;47;6;48;309;40;52
24.11.2023 13:00;123;291;32;18;49;37;2;28;;28;;85;4;52;414;50;86
24.11.2023 14:00;145;300;42;20;64;65;2;36;;21;;76;3;53;445;62;129
24.11.2023 15:00;165;291;43;21;80;59;2;76;;25;;111;13;83;456;64;139
24.11.2023 16:00;168;356;45;21;71;60;6;45;;32;;95;17;66;524;66;131
24.11.2023 17:00;133;304;28;10;61;44;0;24;;28;;105;9;38;437;38;105
24.11.2023 18:00;120;261;25;11;31;31;0;14;;16;;33;4;25;381;36;62
24.11.2023 19:00;103;180;18;6;25;15;0;8;;24;;18;3;27;283;24;40
24.11.2023 20:00;81;118;3;2;9;14;0;6;;5;;10;1;13;199;5;23
24.11.2023 21:00;46;68;7;2;7;8;1;2;;3;;8;2;14;114;9;15
24.11.2023 22:00;33;88;6;1;4;8;1;3;;2;;9;0;17;121;7;12
24.11.2023 23:00;34;51;5;1;6;3;0;1;;1;;0;1;9;85;6;9
25.11.2023 00:00;18;62;4;2;2;5;1;0;;2;;2;0;3;80;6;7
25.11.2023 01:00;7;47;1;0;6;1;0;3;;0;;3;0;2;54;1;7
25.11.2023 02:00;1;8;2;0;1;1;0;0;;2;;1;1;0;9;2;2
25.11.2023 03:00;3;7;0;0;0;0;0;0;;0;;0;0;0;10;0;0
25.11.2023 04:00;0;5;1;0;3;1;0;0;;0;;3;0;0;5;1;4
25.11.2023 05:00;5;18;3;3;4;1;0;1;;3;;0;0;1;23;6;5
25.11.2023 06:00;8;15;2;2;7;3;0;3;;1;;4;0;4;23;4;10
25.11.2023 07:00;15;27;2;4;2;10;0;7;;1;;5;1;3;42;6;12
25.11.2023 08:00;32;37;7;2;17;7;0;10;;5;;20;5;7;69;9;24
25.11.2023 09:00;63;110;11;4;13;14;1;9;;15;;24;5;28;173;15;27
25.11.2023 10:00;97;122;16;15;21;15;4;19;;18;;37;15;36;219;31;36
25.11.2023 11:00;94;155;27;7;17;16;4;31;;21;;35;15;51;249;34;33
25.11.2023 12:00;110;179;18;20;27;19;2;33;;14;;41;15;79;289;38;46
25.11.2023 13:00;121;172;19;11;21;29;3;21;;14;;71;25;46;293;30;50
25.11.2023 14:00;75;180;15;9;20;17;3;11;;9;;27;13;30;255;24;37
25.11.2023 15:00;93;147;25;7;20;16;1;20;;28;;43;14;43;240;32;36
25.11.2023 16:00;71;153;12;5;16;18;3;26;;13;;23;14;31;224;17;34
25.11.2023 17:00;71;109;12;5;24;11;2;10;;2;;27;2;17;180;17;35
25.11.2023 18:00;52;125;8;5;18;9;0;9;;5;;22;5;13;177;13;27
25.11.2023 19:00;58;105;2;2;11;6;0;4;;2;;14;5;14;163;4;17
25.11.2023 20:00;50;85;2;3;12;8;0;6;;6;;8;4;9;135;5;20
25.11.2023 21:00;38;70;2;2;4;4;0;4;;4;;7;0;8;108;4;8
25.11.2023 22:00;39;51;2;2;7;5;0;1;;2;;4;0;8;90;4;12
25.11.2023 23:00;25;43;5;0;0;5;1;12;;2;;11;3;3;68;5;5
26.11.2023 00:00;13;48;9;4;9;1;0;2;;2;;1;0;4;61;13;10
26.11.2023 01:00;10;29;1;0;4;2;0;2;;1;;5;0;3;39;1;6
26.11.2023 02:00;7;21;0;4;1;1;0;0;;1;;5;0;2;28;4;2
26.11.2023 03:00;3;9;0;0;0;1;0;1;;1;;1;0;2;12;0;1
26.11.2023 04:00;2;9;0;1;0;0;0;2;;0;;2;0;0;11;1;0
26.11.2023 05:00;8;7;3;0;1;3;0;0;;0;;5;0;1;15;3;4
26.11.2023 06:00;8;6;2;0;6;0;0;1;;0;;0;1;1;14;2;6
26.11.2023 07:00;5;8;5;2;4;6;1;7;;1;;5;3;5;13;7;10
26.11.2023 08:00;16;22;5;6;9;15;2;15;;5;;22;18;19;38;11;24
26.11.2023 09:00;35;74;14;11;21;22;6;24;;16;;36;24;39;109;25;43
26.11.2023 10:00;75;104;20;16;35;30;12;46;;16;;76;27;66;179;36;65
26.11.2023 11:00;70;99;45;22;26;49;17;39;;22;;74;37;71;169;67;75
26.11.2023 12:00;75;103;26;16;25;25;7;75;;13;;67;40;40;178;42;50
26.11.2023 13:00;79;134;14;12;26;29;9;30;;11;;52;20;41;213;26;55
26.11.2023 14:00;69;118;20;5;36;23;5;28;;25;;52;24;44;187;25;59
26.11.2023 15:00;73;125;15;13;20;19;5;39;;18;;48;18;36;198;28;39
26.11.2023 16:00;61;110;14;16;19;22;9;12;;13;;42;15;35;171;30;41
26.11.2023 17:00;67;128;9;4;12;10;1;10;;8;;21;5;9;195;13;22
26.11.2023 18:00;52;84;10;2;17;11;0;11;;6;;18;14;10;136;12;28
26.11.2023 19:00;60;77;8;10;15;7;1;10;;4;;4;3;19;137;18;22
26.11.2023 20:00;38;66;1;1;3;3;1;3;;3;;9;5;12;104;2;6
26.11.2023 21:00;31;49;4;1;6;4;0;6;;7;;11;1;4;80;5;10
26.11.2023 22:00;21;40;3;3;6;4;0;1;;4;;10;0;6;61;6;10
26.11.2023 23:00;8;10;1;0;2;3;5;0;;2;;0;1;1;18;1;5
27.11.2023 00:00;4;4;0;0;1;1;0;0;;2;;1;2;1;8;0;2
27.11.2023 01:00;5;2;0;0;0;3;0;0;;0;;0;0;0;7;0;3
27.11.2023 02:00;2;1;0;0;0;0;0;0;;0;;0;0;1;3;0;0
27.11.2023 03:00;2;1;0;1;2;1;0;0;;0;;0;0;0;3;1;3
27.11.2023 04:00;6;8;1;3;2;0;1;0;;0;;1;2;0;14;4;2
27.11.2023 05:00;29;31;8;3;16;8;0;2;;2;;9;1;6;60;11;24
27.11.2023 06:00;90;91;11;21;44;17;5;17;;8;;26;12;21;181;32;61
27.11.2023 07:00;227;191;40;40;83;81;6;49;;33;;96;23;79;418;80;164
27.11.2023 08:00;199;189;29;24;76;73;4;52;;20;;117;11;53;388;53;149
27.11.2023 09:00;93;100;12;6;25;33;2;16;;11;;54;11;25;193;18;58
27.11.2023 10:00;50;68;7;3;18;14;1;7;;5;;16;13;16;118;10;32
27.11.2023 11:00;29;71;6;1;15;10;8;9;;10;;17;2;12;100;7;25
27.11.2023 12:00;51;94;16;2;20;12;3;8;;9;;21;5;16;145;18;32
27.11.2023 13:00;62;108;11;3;15;12;3;7;;12;;26;5;19;170;14;27
27.11.2023 14:00;63;157;19;12;29;24;2;9;;13;;33;3;20;220;31;53
27.11.2023 15:00;90;185;17;11;43;35;2;23;;16;;46;10;38;275;28;78
27.11.2023 16:00;123;252;40;26;62;45;10;24;;20;;69;20;55;375;66;107
27.11.2023 17:00;103;231;30;13;55;46;1;26;;18;;75;14;53;334;43;101
27.11.2023 18:00;89;214;25;10;48;28;0;15;;8;;56;2;28;303;35;76
27.11.2023 19:00;55;117;7;10;17;18;2;5;;18;;14;3;17;172;17;35
27.11.2023 20:00;35;78;4;4;16;9;0;10;;5;;13;3;11;113;8;25
27.11.2023 21:00;22;57;7;1;3;2;0;3;;6;;5;3;6;79;8;5
27.11.2023 22:00;20;37;2;0;4;7;0;0;;1;;3;1;5;57;2;11
27.11.2023 23:00;9;10;0;1;2;2;0;0;;1;;1;0;0;19;1;4
28.11.2023 00:00;4;7;0;0;0;1;0;0;;0;;0;0;0;11;0;1
28.11.2023 01:00;1;4;0;0;0;1;0;0;;1;;0;0;0;5;0;1
28.11.2023 02:00;2;1;0;0;2;0;0;1;;0;;0;0;0;3;0;2
28.11.2023 03:00;1;0;0;0;3;0;0;0;;1;;0;0;2;1;0;3
28.11.2023 04:00;2;8;2;3;4;2;1;0;;0;;1;1;0;10;5;6
28.11.2023 05:00;29;28;5;4;16;8;0;2;;1;;10;1;3;57;9;24
28.11.2023 06:00;84;86;18;29;33;23;7;16;;4;;26;11;28;170;47;56
28.11.2023 07:00;284;267;48;39;125;112;11;49;;42;;139;29;117;551;87;237
28.11.2023 08:00;318;319;64;34;175;155;26;106;;43;;260;23;117;637;98;330
28.11.2023 09:00;151;181;17;17;64;52;11;42;;18;;120;13;49;332;34;116
28.11.2023 10:00;107;135;9;13;26;28;5;20;;19;;36;12;36;242;22;54
28.11.2023 11:00;90;159;11;8;24;25;4;17;;19;;49;16;41;249;19;49
28.11.2023 12:00;95;226;26;12;36;32;7;24;;17;;61;15;36;321;38;68
28.11.2023 13:00;120;229;23;17;54;50;7;31;;25;;65;22;63;349;40;104
28.11.2023 14:00;124;283;27;15;55;37;13;27;;32;;81;30;52;407;42;92
28.11.2023 15:00;155;308;42;24;81;67;15;51;;28;;120;38;77;463;66;148
28.11.2023 16:00;173;354;53;35;99;81;15;57;;40;;117;23;78;527;88;180
28.11.2023 17:00;184;458;46;17;126;95;10;63;;29;;174;28;101;642;63;221
28.11.2023 18:00;176;335;39;16;81;57;13;18;;19;;102;20;58;511;55;138
28.11.2023 19:00;123;241;22;12;40;32;3;28;;16;;38;16;43;364;34;72
28.11.2023 20:00;72;179;5;6;22;16;2;15;;8;;25;7;33;251;11;38
28.11.2023 21:00;68;129;9;1;21;4;0;6;;7;;17;5;18;197;10;25
28.11.2023 22:00;43;99;11;5;15;7;1;3;;1;;8;1;6;142;16;22
28.11.2023 23:00;14;37;9;1;5;3;0;2;;2;;2;0;3;51;10;8
29.11.2023 00:00;8;12;0;1;2;0;0;0;;0;;1;1;2;20;1;2
29.11.2023 01:00;4;3;0;0;0;1;0;0;;0;;0;0;0;7;0;1
29.11.2023 02:00;2;2;3;0;0;0;0;0;;0;;1;0;0;4;3;0
29.11.2023 03:00;5;3;0;1;3;0;0;0;;0;;0;0;1;8;1;3
29.11.2023 04:00;2;9;1;1;7;2;1;1;;0;;4;3;0;11;2;9
29.11.2023 05:00;26;28;10;0;16;4;1;4;;1;;8;3;4;54;10;20
29.11.2023 06:00;92;82;20;25;37;28;11;17;;6;;31;9;17;174;45;65
29.11.2023 07:00;267;257;58;40;122;126;18;65;;34;;140;37;123;524;98;248
29.11.2023 08:00;296;272;37;35;138;137;12;93;;40;;231;27;86;568;72;275
29.11.2023 09:00;131;168;20;16;55;65;11;37;;18;;117;15;50;299;36;120
29.11.2023 10:00;95;126;12;4;27;27;7;22;;12;;46;12;30;221;16;54
29.11.2023 11:00;82;143;16;10;22;27;3;42;;18;;42;21;32;225;26;49
29.11.2023 12:00;92;201;29;7;36;43;8;39;;13;;55;22;50;293;36;79
29.11.2023 13:00;107;246;17;6;42;40;8;33;;27;;81;16;53;353;23;82
29.11.2023 14:00;106;248;27;20;47;52;7;28;;20;;78;18;42;354;47;99
29.11.2023 15:00;144;248;31;14;73;61;11;46;;19;;84;20;57;392;45;134
29.11.2023 16:00;187;339;58;33;103;82;17;52;;27;;169;37;91;526;91;185
29.11.2023 17:00;192;395;41;26;109;73;8;46;;28;;150;21;95;587;67;182
29.11.2023 18:00;155;306;32;12;74;64;9;36;;23;;97;22;47;461;44;138
29.11.2023 19:00;121;220;18;5;30;33;2;26;;11;;63;16;41;341;23;63
29.11.2023 20:00;85;144;9;7;22;13;1;11;;9;;25;6;17;229;16;35
29.11.2023 21:00;67;127;7;11;31;7;1;6;;5;;16;5;26;194;18;38
29.11.2023 22:00;43;100;5;4;9;13;2;7;;4;;14;2;19;143;9;22
29.11.2023 23:00;25;53;2;0;6;4;0;2;;3;;6;0;4;78;2;10
30.11.2023 00:00;6;16;1;0;3;1;0;2;;0;;3;0;1;22;1;4
30.11.2023 01:00;3;6;2;0;1;0;0;0;;1;;1;0;0;9;2;1
30.11.2023 02:00;0;1;0;0;0;1;0;0;;0;;0;0;0;1;0;1
30.11.2023 03:00;2;1;0;0;1;0;0;0;;0;;1;0;0;3;0;1
30.11.2023 04:00;3;10;1;2;4;1;1;0;;1;;2;2;2;13;3;5
30.11.2023 05:00;34;28;5;3;19;10;0;4;;3;;7;3;6;62;8;29
30.11.2023 06:00;78;72;16;18;36;21;11;16;;8;;18;14;21;150;34;57
30.11.2023 07:00;259;250;54;44;104;100;17;48;;37;;141;32;117;509;98;204
30.11.2023 08:00;307;309;43;33;142;149;17;111;;32;;240;34;111;616;76;291
30.11.2023 09:00;147;174;11;16;69;56;8;35;;13;;108;15;51;321;27;125
30.11.2023 10:00;97;131;16;10;22;29;4;26;;22;;44;18;34;228;26;51
30.11.2023 11:00;74;150;8;8;18;19;2;21;;12;;41;14;41;224;16;37
30.11.2023 12:00;117;198;23;8;30;25;7;30;;12;;58;20;60;315;31;55
30.11.2023 13:00;115;230;22;6;45;55;7;36;;19;;69;17;55;345;28;100
30.11.2023 14:00;126;242;35;13;57;52;19;44;;23;;65;13;57;368;48;109
30.11.2023 15:00;152;304;46;21;72;62;13;54;;25;;123;21;75;456;67;134
30.11.2023 16:00;180;353;65;29;98;92;19;60;;30;;167;29;95;533;94;190
30.11.2023 17:00;170;401;41;31;82;86;14;47;;32;;143;28;94;571;72;168
30.11.2023 18:00;171;368;33;19;72;60;11;37;;30;;107;30;64;539;52;132
30.11.2023 19:00;120;292;16;7;41;22;8;22;;18;;53;10;46;412;23;63
30.11.2023 20:00;74;151;2;1;23;17;4;7;;8;;21;3;13;225;3;40
30.11.2023 21:00;56;131;11;2;19;9;1;4;;11;;21;6;20;187;13;28
30.11.2023 22:00;45;130;5;3;8;14;2;4;;10;;20;0;12;175;8;22
30.11.2023 23:00;40;58;3;1;5;1;0;3;;5;;9;0;6;98;4;6
01.12.2023 00:00;13;22;4;0;5;2;0;1;;0;;3;1;3;35;4;7
01.12.2023 01:00;1;16;1;0;3;0;0;1;;0;;1;0;0;17;1;3
01.12.2023 02:00;11;2;0;2;0;0;0;1;;0;;0;1;0;13;2;0
01.12.2023 03:00;7;12;2;0;6;0;0;0;;0;;0;0;1;19;2;6
01.12.2023 04:00;2;12;3;4;4;2;1;0;;0;;6;1;3;14;7;6
01.12.2023 05:00;25;22;5;3;9;2;0;2;;2;;7;1;7;47;8;11
01.12.2023 06:00;72;70;20;15;37;12;6;14;;7;;15;11;19;142;35;49
01.12.2023 07:00;222;213;37;51;91;83;23;50;;30;;88;37;102;435;88;174
01.12.2023 08:00;241;211;34;18;105;100;13;79;;40;;151;21;76;452;52;205
01.12.2023 09:00;150;184;24;12;45;47;8;32;;19;;87;13;34;334;36;92
01.12.2023 10:00;126;163;13;9;31;23;6;18;;21;;45;22;38;289;22;54
01.12.2023 11:00;102;194;18;14;41;33;9;20;;20;;52;17;52;296;32;74
01.12.2023 12:00;141;224;27;20;58;34;9;31;;12;;78;26;52;365;47;92
01.12.2023 13:00;159;315;27;15;49;38;19;45;;28;;71;26;89;474;42;87
01.12.2023 14:00;143;286;45;12;54;51;14;36;;21;;90;23;57;429;57;105
01.12.2023 15:00;167;332;40;18;60;57;11;51;;27;;107;21;74;499;58;117
01.12.2023 16:00;158;337;47;27;81;48;14;66;;36;;114;25;62;495;74;129
01.12.2023 17:00;132;308;29;10;61;53;6;36;;28;;98;29;79;440;39;114
01.12.2023 18:00;132;287;22;13;40;31;8;18;;22;;66;10;50;419;35;71
01.12.2023 19:00;95;194;12;11;26;24;2;12;;12;;30;12;33;289;23;50
01.12.2023 20:00;60;143;11;2;11;10;3;6;;7;;18;7;15;203;13;21
01.12.2023 21:00;51;93;5;1;19;12;0;2;;1;;18;5;19;144;6;31
01.12.2023 22:00;60;105;6;2;12;7;1;2;;2;;13;0;12;165;8;19
01.12.2023 23:00;35;74;10;0;13;5;0;5;;2;;13;2;7;109;10;18
02.12.2023 00:00;19;51;2;1;6;5;0;3;;3;;16;0;8;70;3;11
02.12.2023 01:00;6;31;1;0;4;0;0;0;;1;;0;0;3;37;1;4
02.12.2023 02:00;1;21;0;0;1;3;1;0;;1;;6;0;1;22;0;4
02.12.2023 03:00;6;15;1;0;1;0;0;0;;0;;3;0;0;21;1;1
02.12.2023 04:00;0;7;1;2;1;0;0;1;;0;;3;0;0;7;3;1
02.12.2023 05:00;2;9;1;0;2;3;1;0;;0;;3;0;0;11;1;5
02.12.2023 06:00;4;16;1;0;4;3;1;6;;0;;2;5;1;20;1;7
02.12.2023 07:00;13;17;4;4;8;4;0;0;;2;;6;0;3;30;8;12
02.12.2023 08:00;34;39;4;3;7;9;7;8;;1;;11;9;7;73;7;16
02.12.2023 09:00;71;91;12;9;19;12;1;14;;17;;26;15;35;162;21;31
02.12.2023 10:00;94;128;26;4;18;19;7;14;;22;;33;11;45;222;30;37
02.12.2023 11:00;98;184;17;12;37;27;18;23;;21;;50;24;55;282;29;64
02.12.2023 12:00;108;159;19;15;25;23;9;25;;17;;65;22;63;267;34;48
02.12.2023 13:00;112;195;20;10;22;21;11;32;;16;;53;26;43;307;30;43
02.12.2023 14:00;133;192;28;10;26;23;14;27;;24;;52;26;56;325;38;49
02.12.2023 15:00;97;185;24;18;18;35;17;42;;12;;72;34;59;282;42;53
02.12.2023 16:00;71;161;26;12;23;24;17;39;;17;;49;34;54;232;38;47
02.12.2023 17:00;76;157;12;8;11;6;2;7;;23;;33;7;23;233;20;17
02.12.2023 18:00;73;154;8;4;16;9;1;11;;8;;31;4;21;227;12;25
02.12.2023 19:00;78;155;18;1;8;11;4;2;;10;;12;6;17;233;19;19
02.12.2023 20:00;60;80;8;2;8;3;3;3;;2;;10;1;11;140;10;11
02.12.2023 21:00;38;91;3;0;4;7;0;6;;4;;10;3;6;129;3;11
02.12.2023 22:00;25;55;1;0;7;5;0;5;;1;;6;6;2;80;1;12
02.12.2023 23:00;24;43;5;0;10;2;1;4;;0;;10;0;3;67;5;12
03.12.2023 00:00;19;43;4;0;3;2;0;2;;1;;1;0;6;62;4;5
03.12.2023 01:00;17;28;0;3;3;1;0;0;;5;;2;0;0;45;3;4
03.12.2023 02:00;17;26;0;0;1;1;0;0;;1;;1;0;2;43;0;2
03.12.2023 03:00;5;10;1;0;0;2;0;0;;0;;1;0;0;15;1;2
03.12.2023 04:00;4;5;2;2;1;3;0;1;;3;;4;1;0;9;4;4
03.12.2023 05:00;5;7;1;0;0;1;0;0;;0;;2;0;2;12;1;1
03.12.2023 06:00;3;12;2;2;4;1;0;3;;0;;0;3;4;15;4;5
03.12.2023 07:00;7;12;5;3;2;6;3;0;;2;;6;1;4;19;8;8
03.12.2023 08:00;18;27;9;10;11;4;4;12;;8;;11;11;9;45;19;15
03.12.2023 09:00;37;59;22;7;35;20;6;20;;13;;31;11;37;96;29;55
03.12.2023 10:00;73;85;30;14;36;27;6;32;;23;;52;22;67;158;44;63
03.12.2023 11:00;66;117;31;20;37;35;12;46;;22;;83;26;64;183;51;72
03.12.2023 12:00;87;126;35;30;53;32;21;65;;21;;70;48;75;213;65;85
03.12.2023 13:00;106;166;33;18;65;47;11;70;;27;;87;48;96;272;51;112
03.12.2023 14:00;103;173;45;27;45;47;24;60;;32;;72;36;105;276;72;92
03.12.2023 15:00;104;178;29;23;51;31;18;63;;37;;78;37;76;282;52;82
03.12.2023 16:00;79;141;36;11;28;24;13;24;;11;;39;24;55;220;47;52
03.12.2023 17:00;69;179;7;5;26;17;3;16;;24;;29;14;28;248;12;43
03.12.2023 18:00;72;103;2;1;12;8;1;12;;11;;12;12;18;175;3;20
03.12.2023 19:00;34;87;8;2;10;8;3;11;;6;;7;7;7;121;10;18
03.12.2023 20:00;33;68;0;0;8;8;0;10;;1;;11;3;7;101;0;16
03.12.2023 21:00;23;33;3;2;4;5;0;3;;1;;4;7;3;56;5;9
03.12.2023 22:00;10;30;2;0;4;2;0;0;;1;;3;0;3;40;2;6
03.12.2023 23:00;4;9;1;0;4;0;0;1;;0;;0;1;0;13;1;4
04.12.2023 00:00;1;5;1;1;1;0;0;0;;0;;0;0;1;6;2;1
04.12.2023 01:00;1;4;1;0;0;0;0;0;;0;;0;0;0;5;1;0
04.12.2023 02:00;1;0;0;0;0;0;0;0;;1;;0;0;0;1;0;0
04.12.2023 03:00;3;1;0;1;1;0;0;0;;0;;0;0;0;4;1;1
04.12.2023 04:00;4;8;2;3;5;3;1;1;;3;;3;1;0;12;5;8
04.12.2023 05:00;18;18;6;0;7;4;0;2;;0;;7;2;8;36;6;11
04.12.2023 06:00;54;66;9;13;26;20;5;6;;7;;17;11;16;120;22;46
04.12.2023 07:00;172;176;30;28;72;54;12;38;;25;;68;18;71;348;58;126
04.12.2023 08:00;230;197;28;22;95;94;5;70;;24;;146;19;55;427;50;189
04.12.2023 09:00;105;127;12;7;47;40;2;27;;14;;72;7;32;232;19;87
04.12.2023 10:00;80;110;9;2;21;15;2;15;;10;;34;11;16;190;11;36
04.12.2023 11:00;61;100;7;0;14;11;1;10;;7;;32;7;19;161;7;25
04.12.2023 12:00;68;124;9;3;19;24;0;11;;7;;26;8;20;192;12;43
04.12.2023 13:00;82;156;20;7;24;20;6;15;;12;;37;15;23;238;27;44
04.12.2023 14:00;91;192;13;14;35;24;4;20;;11;;49;6;25;283;27;59
04.12.2023 15:00;111;255;23;11;54;31;6;29;;25;;68;14;37;366;34;85
04.12.2023 16:00;166;293;36;23;61;48;12;40;;26;;102;19;69;459;59;109
04.12.2023 17:00;135;324;29;9;73;55;4;32;;16;;98;15;61;459;38;128
04.12.2023 18:00;100;223;20;5;51;35;3;13;;8;;52;8;32;323;25;86
04.12.2023 19:00;75;127;8;3;21;16;0;8;;5;;23;4;14;202;11;37
04.12.2023 20:00;54;108;11;3;9;6;1;11;;3;;15;2;14;162;14;15
04.12.2023 21:00;28;72;3;1;9;5;0;1;;1;;8;1;4;100;4;14
04.12.2023 22:00;14;43;5;3;5;6;0;2;;0;;2;0;3;57;8;11
04.12.2023 23:00;6;13;2;0;1;0;0;0;;1;;2;0;2;19;2;1
05.12.2023 00:00;3;7;0;0;0;1;0;0;;0;;0;0;0;10;0;1
05.12.2023 01:00;0;2;0;1;0;0;0;0;;0;;1;0;0;2;1;0
05.12.2023 02:00;2;4;0;0;0;0;0;0;;1;;0;0;0;6;0;0
05.12.2023 03:00;5;0;0;1;2;0;0;0;;2;;0;0;0;5;1;2
05.12.2023 04:00;4;8;2;4;7;2;1;0;;0;;3;1;3;12;6;9
05.12.2023 05:00;23;26;5;3;16;3;1;1;;2;;7;0;6;49;8;19
05.12.2023 06:00;85;88;15;17;35;20;7;12;;8;;21;11;17;173;32;55
05.12.2023 07:00;284;244;45;39;125;90;21;67;;31;;129;41;103;528;84;215
05.12.2023 08:00;283;302;58;35;161;137;27;104;;34;;251;30;105;585;93;298
05.12.2023 09:00;162;173;30;17;65;71;13;37;;13;;105;18;34;335;47;136
05.12.2023 10:00;59;122;9;7;28;15;1;18;;9;;26;12;28;181;16;43
05.12.2023 11:00;85;110;8;7;21;15;6;19;;9;;29;15;17;195;15;36
05.12.2023 12:00;70;158;16;8;22;20;5;19;;17;;36;13;37;228;24;42
05.12.2023 13:00;110;205;16;8;39;33;4;19;;15;;44;13;37;315;24;72
05.12.2023 14:00;111;220;24;11;25;39;6;14;;25;;66;11;42;331;35;64
05.12.2023 15:00;150;265;36;19;63;46;6;46;;22;;101;18;55;415;55;109
05.12.2023 16:00;143;346;50;20;84;69;10;46;;23;;107;25;70;489;70;153
05.12.2023 17:00;182;345;41;15;112;65;6;42;;25;;142;27;71;527;56;177
05.12.2023 18:00;131;255;24;14;72;42;13;24;;21;;106;14;34;386;38;114
05.12.2023 19:00;122;215;13;3;33;27;4;20;;14;;44;6;36;337;16;60
05.12.2023 20:00;54;155;6;4;23;11;1;5;;9;;21;8;15;209;10;34
05.12.2023 21:00;38;116;8;0;19;6;0;3;;5;;9;11;22;154;8;25
05.12.2023 22:00;37;96;12;6;8;5;4;6;;2;;11;7;10;133;18;13
05.12.2023 23:00;15;35;3;1;3;5;1;1;;3;;5;1;0;50;4;8
06.12.2023 00:00;4;12;1;0;1;2;0;0;;0;;1;0;0;16;1;3
06.12.2023 01:00;5;8;0;0;0;0;0;0;;2;;0;0;0;13;0;0
06.12.2023 02:00;5;7;0;0;0;0;0;0;;1;;1;0;0;12;0;0
06.12.2023 03:00;4;0;0;1;1;0;0;0;;0;;0;1;0;4;1;1
06.12.2023 04:00;2;14;0;4;3;0;1;0;;0;;2;0;0;16;4;3
06.12.2023 05:00;29;25;5;5;10;5;1;1;;1;;11;0;6;54;10;15
06.12.2023 06:00;75;65;18;21;31;26;8;13;;7;;25;12;18;140;39;57
06.12.2023 07:00;232;237;40;33;136;100;26;64;;34;;115;48;118;469;73;236
06.12.2023 08:00;306;311;44;32;153;145;14;101;;43;;258;42;110;617;76;298
06.12.2023 09:00;153;173;17;9;55;54;8;51;;23;;110;21;40;326;26;109
06.12.2023 10:00;94;132;11;6;20;28;3;18;;14;;41;11;34;226;17;48
06.12.2023 11:00;83;156;19;10;23;27;5;29;;15;;45;24;35;239;29;50
06.12.2023 12:00;95;187;19;10;31;32;11;27;;16;;55;14;56;282;29;63
06.12.2023 13:00;131;257;42;6;34;38;19;37;;18;;71;20;61;388;48;72
06.12.2023 14:00;121;263;22;23;59;38;13;31;;24;;71;26;54;384;45;97
06.12.2023 15:00;144;295;34;20;93;70;20;56;;32;;131;32;75;439;54;163
06.12.2023 16:00;188;412;43;26;93;83;26;84;;53;;158;45;119;600;69;176
06.12.2023 17:00;202;453;31;21;100;91;19;48;;34;;158;29;99;655;52;191
06.12.2023 18:00;164;330;21;15;83;56;6;41;;26;;115;21;64;494;36;139
06.12.2023 19:00;102;238;24;7;37;15;7;16;;10;;45;14;37;340;31;52
06.12.2023 20:00;66;167;12;4;25;18;4;20;;8;;40;4;17;233;16;43
06.12.2023 21:00;61;135;10;2;12;7;0;9;;4;;18;7;14;196;12;19
06.12.2023 22:00;34;148;2;5;13;8;2;7;;5;;10;1;13;182;7;21
06.12.2023 23:00;32;55;2;1;3;3;0;2;;4;;5;1;7;87;3;6
07.12.2023 00:00;3;21;0;0;2;1;0;2;;0;;1;0;3;24;0;3
07.12.2023 01:00;2;2;0;1;1;0;0;0;;2;;1;0;0;4;1;1
07.12.2023 02:00;0;2;0;0;0;0;0;0;;1;;0;0;0;2;0;0
07.12.2023 03:00;3;3;0;3;0;0;0;0;;1;;0;0;0;6;3;0
07.12.2023 04:00;2;7;3;2;3;1;1;0;;0;;2;1;0;9;5;4
07.12.2023 05:00;19;21;4;8;18;8;0;2;;2;;9;2;9;40;12;26
07.12.2023 06:00;92;80;21;12;35;22;9;19;;6;;32;19;20;172;33;57
07.12.2023 07:00;302;255;51;38;143;125;30;81;;53;;154;44;126;557;89;268
07.12.2023 08:00;324;298;53;29;187;160;24;116;;40;;249;33;105;622;82;347
07.12.2023 09:00;180;205;19;14;71;76;20;55;;19;;109;26;53;385;33;147
07.12.2023 10:00;112;170;12;10;40;40;15;43;;12;;62;21;58;282;22;80
07.12.2023 11:00;102;187;24;19;40;43;10;39;;17;;62;30;62;289;43;83
07.12.2023 12:00;117;242;27;5;40;33;23;38;;30;;81;29;82;359;32;73
07.12.2023 13:00;126;269;30;11;81;69;19;57;;22;;107;37;85;395;41;150
07.12.2023 14:00;171;277;39;23;81;66;25;46;;18;;102;33;97;448;62;147
07.12.2023 15:00;192;311;60;14;97;82;28;62;;32;;129;40;116;503;74;179
07.12.2023 16:00;194;412;58;20;122;111;19;79;;40;;172;41;110;606;78;233
07.12.2023 17:00;221;450;51;30;122;82;22;62;;34;;151;45;102;671;81;204
07.12.2023 18:00;150;396;30;18;83;63;12;51;;21;;108;32;66;546;48;146
07.12.2023 19:00;131;300;17;7;38;37;5;24;;27;;56;19;46;431;24;75
07.12.2023 20:00;81;175;10;4;29;17;3;14;;14;;27;12;23;256;14;46
07.12.2023 21:00;77;175;11;5;19;7;3;11;;5;;20;8;26;252;16;26
07.12.2023 22:00;55;139;6;5;15;10;1;8;;4;;25;3;9;194;11;25
07.12.2023 23:00;26;50;2;2;11;6;0;2;;3;;4;0;8;76;4;17
08.12.2023 00:00;8;28;3;1;3;2;0;1;;1;;0;0;1;36;4;5
08.12.2023 01:00;2;8;0;1;3;0;0;0;;3;;2;0;0;10;1;3
08.12.2023 02:00;1;3;0;0;0;0;0;0;;0;;0;0;0;4;0;0
08.12.2023 03:00;2;3;0;1;1;0;0;2;;0;;2;0;0;5;1;1
08.12.2023 04:00;3;6;0;5;2;1;1;0;;0;;1;1;0;9;5;3
08.12.2023 05:00;20;11;5;3;12;6;2;2;;1;;12;2;5;31;8;18
08.12.2023 06:00;48;49;13;14;23;13;3;11;;4;;15;13;12;97;27;36
08.12.2023 07:00;203;202;35;41;69;62;16;47;;30;;91;31;84;405;76;131
08.12.2023 08:00;230;234;28;8;108;99;10;66;;28;;146;15;58;464;36;207
08.12.2023 09:00;155;167;14;14;45;42;9;26;;11;;83;14;38;322;28;87
08.12.2023 10:00;97;156;15;10;30;17;9;23;;12;;41;20;33;253;25;47
08.12.2023 11:00;106;194;18;9;35;17;4;26;;19;;43;20;45;300;27;52
08.12.2023 12:00;136;212;19;11;35;20;4;20;;23;;40;13;41;348;30;55
08.12.2023 13:00;137;275;33;10;46;51;5;22;;27;;62;14;67;412;43;97
08.12.2023 14:00;121;283;34;21;60;68;15;45;;13;;84;30;69;404;55;128
08.12.2023 15:00;151;317;33;14;60;58;28;68;;37;;104;20;81;468;47;118
08.12.2023 16:00;131;306;39;22;62;52;22;57;;30;;131;34;74;437;61;114
08.12.2023 17:00;127;286;30;20;56;42;12;28;;20;;100;23;52;413;50;98
08.12.2023 18:00;148;267;25;10;45;30;8;27;;23;;67;17;47;415;35;75
08.12.2023 19:00;115;228;14;7;27;18;5;11;;10;;31;14;38;343;21;45
08.12.2023 20:00;59;130;8;1;21;13;4;8;;7;;38;6;15;189;9;34
08.12.2023 21:00;45;156;8;9;11;12;5;13;;3;;17;7;22;201;17;23
08.12.2023 22:00;41;98;5;4;8;3;2;8;;0;;16;3;10;139;9;11
08.12.2023 23:00;28;66;4;0;8;6;0;2;;4;;23;2;9;94;4;14
09.12.2023 00:00;33;40;4;1;12;8;1;4;;2;;8;0;8;73;5;20
09.12.2023 01:00;17;39;6;2;8;5;1;0;;0;;3;1;9;56;8;13
09.12.2023 02:00;8;19;2;1;4;4;0;1;;1;;0;1;2;27;3;8
09.12.2023 03:00;1;7;0;0;0;1;0;1;;0;;1;0;1;8;0;1
09.12.2023 04:00;2;6;1;1;1;0;0;1;;0;;2;0;0;8;2;1
09.12.2023 05:00;7;12;1;0;2;1;1;0;;0;;1;2;0;19;1;3
09.12.2023 06:00;20;22;4;1;4;2;0;1;;0;;10;0;5;42;5;6
09.12.2023 07:00;13;16;8;6;6;6;6;4;;2;;11;0;6;29;14;12
09.12.2023 08:00;33;63;14;8;25;8;4;12;;4;;26;13;21;96;22;33
09.12.2023 09:00;74;89;17;12;33;24;5;21;;19;;30;26;59;163;29;57
09.12.2023 10:00;108;176;14;16;26;23;16;35;;20;;52;26;71;284;30;49
09.12.2023 11:00;114;206;29;20;34;42;24;56;;18;;74;43;91;320;49;76
09.12.2023 12:00;118;237;34;29;45;33;20;71;;34;;78;33;104;355;63;78
09.12.2023 13:00;105;186;14;11;31;19;15;49;;28;;57;38;51;291;25;50
09.12.2023 14:00;73;152;11;9;17;24;10;21;;11;;39;9;29;225;20;41
09.12.2023 15:00;54;116;17;4;20;9;2;16;;11;;28;15;29;170;21;29
09.12.2023 16:00;56;98;11;6;11;15;2;15;;12;;16;19;21;154;17;26
09.12.2023 17:00;45;100;4;2;17;14;0;7;;9;;14;8;16;145;6;31
09.12.2023 18:00;35;81;7;0;15;8;1;10;;3;;13;8;9;116;7;23
09.12.2023 19:00;45;76;2;3;3;3;1;1;;8;;8;4;7;121;5;6
09.12.2023 20:00;34;56;4;6;12;6;0;6;;7;;12;4;7;90;10;18
09.12.2023 21:00;30;37;8;2;3;12;1;1;;0;;4;3;2;67;10;15
09.12.2023 22:00;11;48;5;0;5;5;0;2;;3;;6;1;7;59;5;10
09.12.2023 23:00;17;44;3;3;7;3;2;4;;2;;3;1;8;61;6;10
10.12.2023 00:00;11;24;1;1;5;2;3;0;;1;;3;0;5;35;2;7
10.12.2023 01:00;10;22;1;0;2;2;0;2;;1;;0;0;1;32;1;4
10.12.2023 02:00;13;10;1;0;0;3;0;1;;0;;4;1;2;23;1;3
10.12.2023 03:00;6;6;1;0;1;0;0;0;;0;;0;0;1;12;1;1
10.12.2023 04:00;1;2;0;0;0;1;0;0;;0;;1;0;0;3;0;1
10.12.2023 05:00;4;2;1;1;3;1;0;0;;0;;1;1;0;6;2;4
10.12.2023 06:00;7;9;1;1;1;1;0;1;;1;;1;1;2;16;2;2
10.12.2023 07:00;8;16;3;2;3;7;0;8;;0;;6;6;4;24;5;10
10.12.2023 08:00;10;32;7;1;6;7;2;6;;4;;18;11;6;42;8;13
10.12.2023 09:00;33;48;18;6;19;17;5;16;;12;;23;18;20;81;24;36
10.12.2023 10:00;71;124;27;13;31;26;10;63;;14;;53;38;73;195;40;57
10.12.2023 11:00;83;119;48;25;50;53;25;75;;26;;113;59;98;202;73;103
10.12.2023 12:00;136;172;54;29;80;76;37;126;;31;;142;85;145;308;83;156
10.12.2023 13:00;138;224;53;61;89;84;41;131;;33;;169;85;134;362;114;173
10.12.2023 14:00;160;211;44;39;73;54;28;86;;56;;193;61;117;371;83;127
10.12.2023 15:00;144;209;44;23;56;60;37;70;;22;;116;56;107;353;67;116
10.12.2023 16:00;125;197;34;13;56;35;11;44;;18;;128;36;70;322;47;91
10.12.2023 17:00;101;190;14;10;17;21;4;34;;14;;49;29;25;291;24;38
10.12.2023 18:00;63;130;11;4;8;14;0;15;;12;;14;15;18;193;15;22
10.12.2023 19:00;59;100;6;4;9;6;0;0;;4;;10;2;8;159;10;15
10.12.2023 20:00;45;73;6;2;9;3;0;7;;1;;11;10;9;118;8;12
10.12.2023 21:00;39;53;3;1;6;1;1;11;;1;;15;6;5;92;4;7
10.12.2023 22:00;19;32;1;4;3;3;0;2;;1;;4;2;4;51;5;6
10.12.2023 23:00;10;26;0;0;5;1;0;0;;0;;1;2;4;36;0;6
11.12.2023 00:00;2;6;2;0;2;1;0;0;;0;;0;0;1;8;2;3
11.12.2023 01:00;3;7;1;0;0;0;0;3;;0;;0;0;1;10;1;0
11.12.2023 02:00;3;2;0;0;0;0;0;0;;1;;0;0;0;5;0;0
11.12.2023 03:00;2;0;0;1;3;1;0;0;;0;;1;0;0;2;1;4
11.12.2023 04:00;4;6;1;1;4;1;1;0;;0;;1;1;0;10;2;5
11.12.2023 05:00;37;30;11;3;15;11;1;5;;2;;12;2;4;67;14;26
11.12.2023 06:00;100;92;20;30;43;31;8;14;;7;;35;19;33;192;50;74
11.12.2023 07:00;291;274;50;51;109;120;22;81;;36;;150;46;116;565;101;229
11.12.2023 08:00;364;303;47;34;172;142;14;121;;32;;222;48;101;667;81;314
11.12.2023 09:00;173;201;29;15;50;63;7;51;;21;;127;23;57;374;44;113
11.12.2023 10:00;106;163;14;7;31;39;7;40;;11;;59;20;41;269;21;70
11.12.2023 11:00;81;166;33;17;34;23;1;38;;16;;57;26;45;247;50;57
11.12.2023 12:00;129;214;23;6;37;37;3;52;;22;;67;33;54;343;29;74
11.12.2023 13:00;147;270;20;17;56;51;2;52;;31;;95;28;56;417;37;107
11.12.2023 14:00;154;281;30;12;53;48;5;43;;28;;75;24;66;435;42;101
11.12.2023 15:00;133;315;43;12;66;86;5;45;;39;;92;17;59;448;55;152
11.12.2023 16:00;171;388;54;34;111;80;0;61;;32;;122;35;107;559;88;191
11.12.2023 17:00;203;410;36;22;95;95;1;55;;32;;140;26;77;613;58;190
11.12.2023 18:00;158;345;34;10;76;49;3;32;;19;;106;16;62;503;44;125
11.12.2023 19:00;103;258;19;5;36;30;1;25;;17;;63;7;40;361;24;66
11.12.2023 20:00;76;196;9;2;19;10;0;13;;10;;32;6;21;272;11;29
11.12.2023 21:00;58;130;9;2;13;7;0;5;;9;;26;7;17;188;11;20
11.12.2023 22:00;37;106;5;2;6;6;0;12;;3;;6;3;28;143;7;12
11.12.2023 23:00;14;33;4;4;6;7;0;2;;0;;2;1;5;47;8;13
12.12.2023 00:00;3;12;0;0;4;2;0;2;;2;;0;0;0;15;0;6
12.12.2023 01:00;0;7;0;0;0;0;0;0;;0;;1;0;0;7;0;0
12.12.2023 02:00;2;2;0;0;2;0;0;0;;1;;0;3;0;4;0;2
12.12.2023 03:00;6;2;0;0;0;0;0;0;;2;;0;0;0;8;0;0
12.12.2023 04:00;5;4;0;2;2;1;0;0;;0;;0;0;1;9;2;3
12.12.2023 05:00;32;31;11;4;18;12;2;3;;2;;11;1;8;63;15;30
12.12.2023 06:00;106;100;30;32;41;33;3;11;;7;;39;7;29;206;62;74
12.12.2023 07:00;297;318;57;54;126;128;5;83;;48;;163;11;133;615;111;254
12.12.2023 08:00;358;385;62;38;200;180;14;129;;40;;318;13;143;743;100;380
12.12.2023 09:00;206;219;35;12;78;73;7;63;;21;;129;3;62;425;47;151
12.12.2023 10:00;143;192;35;21;39;36;4;54;;31;;93;6;64;335;56;75
12.12.2023 11:00;111;190;27;7;39;39;3;44;;20;;58;9;65;301;34;78
12.12.2023 12:00;136;263;32;13;38;40;4;44;;21;;57;8;66;399;45;78
12.12.2023 13:00;154;307;26;8;56;60;4;49;;35;;96;4;84;461;34;116
12.12.2023 14:00;127;314;41;13;56;52;0;38;;24;;92;2;63;441;54;108
12.12.2023 15:00;189;365;52;16;80;68;2;73;;36;;124;3;75;554;68;148
12.12.2023 16:00;196;407;67;25;105;88;2;73;;29;;156;1;106;603;92;193
12.12.2023 17:00;231;442;45;27;143;102;2;54;;29;;184;1;98;673;72;245
12.12.2023 18:00;206;425;50;22;95;69;0;34;;25;;139;0;68;631;72;164
12.12.2023 19:00;140;323;10;13;60;33;0;42;;18;;55;0;38;463;23;93
12.12.2023 20:00;70;183;7;11;26;18;0;9;;6;;45;0;27;253;18;44
12.12.2023 21:00;73;185;8;3;15;12;0;5;;3;;15;0;25;258;11;27
12.12.2023 22:00;106;182;3;4;18;6;0;11;;8;;25;1;23;288;7;24
12.12.2023 23:00;28;57;4;3;9;8;0;1;;4;;8;0;7;85;7;17
13.12.2023 00:00;3;18;1;0;1;2;0;1;;0;;1;0;0;21;1;3
13.12.2023 01:00;2;10;1;0;2;0;0;0;;0;;0;0;0;12;1;2
13.12.2023 02:00;1;2;0;0;1;0;0;0;;1;;0;0;0;3;0;1
13.12.2023 03:00;2;0;0;2;0;0;0;0;;0;;0;0;0;2;2;0
13.12.2023 04:00;3;4;1;2;4;0;0;0;;0;;1;0;0;7;3;4
13.12.2023 05:00;28;35;9;5;19;9;0;1;;1;;9;0;5;63;14;28
13.12.2023 06:00;102;81;20;21;44;28;0;9;;7;;24;0;30;183;41;72
13.12.2023 07:00;263;289;60;40;155;135;4;64;;41;;167;0;123;552;100;290
13.12.2023 08:00;370;343;54;35;174;171;6;124;;54;;256;0;130;713;89;345
13.12.2023 09:00;177;210;32;10;67;74;2;56;;20;;152;0;65;387;42;141
13.12.2023 10:00;110;182;15;13;37;33;3;36;;20;;71;0;45;292;28;70
13.12.2023 11:00;123;197;25;16;40;34;4;68;;24;;72;0;81;320;41;74
13.12.2023 12:00;130;252;32;24;44;62;0;67;;22;;114;0;82;382;56;106
13.12.2023 13:00;144;294;40;22;79;67;9;64;;37;;111;0;119;438;62;146
13.12.2023 14:00;144;311;41;19;68;73;11;71;;43;;123;0;112;455;60;141
13.12.2023 15:00;180;356;60;19;112;104;3;90;;47;;154;0;150;536;79;216
13.12.2023 16:00;222;426;76;38;136;113;4;93;;47;;190;0;141;648;114;249
13.12.2023 17:00;235;458;46;29;116;102;0;54;;40;;164;0;138;693;75;218
13.12.2023 18:00;191;377;35;22;92;61;0;35;;33;;129;0;70;568;57;153
13.12.2023 19:00;131;281;22;13;38;34;2;27;;9;;76;0;52;412;35;72
13.12.2023 20:00;80;175;15;5;26;22;1;8;;12;;39;0;29;255;20;48
13.12.2023 21:00;63;186;5;3;17;13;0;11;;10;;32;0;16;249;8;30
13.12.2023 22:00;61;167;8;5;22;15;0;5;;3;;32;0;19;228;13;37
13.12.2023 23:00;26;68;8;4;12;9;0;9;;6;;11;0;13;94;12;21
14.12.2023 00:00;19;27;1;0;1;2;0;1;;0;;2;0;3;46;1;3
14.12.2023 01:00;4;4;0;0;3;1;0;1;;0;;1;0;0;8;0;4
14.12.2023 02:00;2;4;0;0;0;0;0;0;;1;;0;0;0;6;0;0
14.12.2023 03:00;2;3;1;1;0;0;0;0;;0;;0;0;0;5;2;0
14.12.2023 04:00;2;4;0;1;1;2;1;0;;0;;2;0;0;6;1;3
14.12.2023 05:00;31;22;10;3;14;9;0;3;;3;;13;0;7;53;13;23
14.12.2023 06:00;98;96;23;34;44;28;0;12;;7;;27;0;19;194;57;72
14.12.2023 07:00;316;272;66;52;128;128;0;61;;31;;150;0;125;588;118;256
14.12.2023 08:00;344;340;42;34;181;178;1;106;;37;;253;0;129;684;76;359
14.12.2023 09:00;187;176;33;17;61;68;2;45;;23;;115;0;57;363;50;129
14.12.2023 10:00;132;171;14;11;36;32;0;32;;12;;60;0;53;303;25;68
14.12.2023 11:00;92;154;14;5;20;30;0;12;;9;;42;0;33;246;19;50
14.12.2023 12:00;110;187;14;10;36;42;0;24;;11;;49;0;37;297;24;78
14.12.2023 13:00;113;252;22;16;37;39;0;28;;26;;71;0;64;365;38;76
14.12.2023 14:00;138;263;30;15;58;47;0;31;;28;;72;0;52;401;45;105
14.12.2023 15:00;149;307;46;16;74;89;0;37;;40;;88;0;64;456;62;163
14.12.2023 16:00;196;408;58;23;94;93;0;51;;42;;170;0;117;604;81;187
14.12.2023 17:00;220;394;38;26;110;107;0;51;;19;;145;0;83;614;64;217
14.12.2023 18:00;176;376;34;24;76;78;0;27;;24;;96;0;59;552;58;154
14.12.2023 19:00;119;299;8;2;36;25;0;14;;15;;49;0;40;418;10;61
14.12.2023 20:00;78;173;10;3;24;10;0;9;;6;;38;0;22;251;13;34
14.12.2023 21:00;61;166;7;2;19;8;0;9;;9;;24;0;16;227;9;27
14.12.2023 22:00;56;112;5;1;22;19;0;9;;4;;30;0;12;168;6;41
14.12.2023 23:00;42;65;3;1;5;6;0;5;;2;;9;0;9;107;4;11
15.12.2023 00:00;14;30;1;1;9;5;0;3;;2;;5;0;0;44;2;14
15.12.2023 01:00;2;19;0;1;1;6;0;1;;0;;9;0;1;21;1;7
15.12.2023 02:00;3;6;2;0;2;0;0;0;;1;;1;0;2;9;2;2
15.12.2023 03:00;2;3;0;2;0;1;0;0;;0;;0;0;0;5;2;1
15.12.2023 04:00;2;8;2;2;3;0;0;0;;0;;1;0;2;10;4;3
15.12.2023 05:00;22;31;5;0;10;8;0;1;;1;;2;0;6;53;5;18
15.12.2023 06:00;63;69;22;24;29;19;0;7;;3;;18;0;14;132;46;48
15.12.2023 07:00;207;235;40;41;77;81;0;32;;26;;76;0;96;442;81;158
15.12.2023 08:00;249;228;38;24;104;88;0;71;;31;;139;0;77;477;62;192
15.12.2023 09:00;169;189;27;17;55;54;0;36;;19;;99;0;48;358;44;109
15.12.2023 10:00;133;185;17;8;35;24;0;16;;15;;35;0;53;318;25;59
15.12.2023 11:00;139;196;19;9;36;35;0;28;;21;;56;0;71;335;28;71
15.12.2023 12:00;166;243;31;17;46;34;0;28;;24;;62;0;59;409;48;80
15.12.2023 13:00;148;338;38;18;65;50;0;35;;28;;71;0;70;486;56;115
15.12.2023 14:00;152;350;41;24;68;58;0;37;;30;;87;0;80;502;65;126
15.12.2023 15:00;176;350;34;22;69;47;0;49;;31;;116;0;80;526;56;116
15.12.2023 16:00;167;365;44;22;79;66;0;52;;37;;116;0;95;532;66;145
15.12.2023 17:00;184;348;23;14;72;36;0;38;;27;;94;0;79;532;37;108
15.12.2023 18:00;168;307;25;9;49;42;0;7;;24;;47;0;44;475;34;91
15.12.2023 19:00;132;273;17;10;26;23;0;15;;11;;39;0;49;405;27;49
15.12.2023 20:00;92;145;9;2;24;14;0;12;;9;;18;0;24;237;11;38
15.12.2023 21:00;54;141;3;3;23;13;0;15;;2;;24;0;16;195;6;36
15.12.2023 22:00;42;137;5;5;6;8;0;5;;14;;28;0;16;179;10;14
15.12.2023 23:00;33;92;9;3;19;6;0;6;;4;;17;0;13;125;12;25
16.12.2023 00:00;24;71;5;1;8;3;0;0;;4;;11;0;8;95;6;11
16.12.2023 01:00;9;52;5;2;5;1;0;0;;3;;5;0;3;61;7;6
16.12.2023 02:00;7;21;1;1;7;1;0;0;;3;;3;0;2;28;2;8
16.12.2023 03:00;4;18;0;2;2;2;0;1;;2;;6;0;3;22;2;4
16.12.2023 04:00;1;8;0;1;1;0;0;2;;0;;0;0;0;9;1;1
16.12.2023 05:00;9;7;1;2;0;1;0;0;;0;;5;0;1;16;3;1
16.12.2023 06:00;8;14;5;0;6;4;0;2;;1;;1;0;3;22;5;10
16.12.2023 07:00;9;21;5;2;6;9;0;3;;1;;10;0;8;30;7;15
16.12.2023 08:00;32;60;10;5;15;10;0;7;;5;;15;0;15;92;15;25
16.12.2023 09:00;91;96;18;8;21;14;0;18;;28;;25;0;39;187;26;35
16.12.2023 10:00;119;180;27;19;26;40;0;32;;33;;67;0;91;299;46;66
16.12.2023 11:00;166;277;40;32;43;30;0;64;;39;;67;0;137;443;72;73
16.12.2023 12:00;162;305;41;20;61;45;0;61;;29;;97;0;124;467;61;106
16.12.2023 13:00;174;325;52;38;54;50;0;57;;52;;126;0;157;499;90;104
16.12.2023 14:00;144;310;50;24;53;60;0;59;;42;;134;0;128;454;74;113
16.12.2023 15:00;158;289;47;19;52;75;0;56;;40;;104;0;131;447;66;127
16.12.2023 16:00;148;294;27;14;38;40;0;51;;29;;81;0;94;442;41;78
16.12.2023 17:00;143;266;22;4;43;27;0;23;;20;;73;0;61;409;26;70
16.12.2023 18:00;117;233;11;14;27;18;0;9;;15;;40;0;44;350;25;45
16.12.2023 19:00;90;167;10;9;12;14;0;6;;15;;30;0;27;257;19;26
16.12.2023 20:00;59;118;5;3;17;9;0;5;;4;;18;0;21;177;8;26
16.12.2023 21:00;47;93;7;1;14;8;0;7;;7;;14;0;19;140;8;22
16.12.2023 22:00;48;90;8;6;10;2;0;4;;0;;15;0;25;138;14;12
16.12.2023 23:00;44;93;3;2;14;4;0;2;;3;;10;0;7;137;5;18
17.12.2023 00:00;19;45;6;1;5;7;0;2;;3;;3;0;6;64;7;12
17.12.2023 01:00;19;37;3;0;4;2;0;1;;4;;1;0;5;56;3;6
17.12.2023 02:00;9;28;1;0;1;0;0;0;;2;;6;0;3;37;1;1
17.12.2023 03:00;2;20;1;1;2;0;0;3;;1;;2;0;1;22;2;2
17.12.2023 04:00;5;12;0;0;0;0;0;0;;0;;2;0;0;17;0;0
17.12.2023 05:00;6;9;0;0;1;0;0;1;;0;;3;0;1;15;0;1
17.12.2023 06:00;3;8;4;0;3;3;0;2;;1;;0;0;4;11;4;6
17.12.2023 07:00;9;7;2;4;6;4;0;2;;0;;3;0;3;16;6;10
17.12.2023 08:00;15;36;8;2;11;8;0;7;;2;;15;0;17;51;10;19
17.12.2023 09:00;55;72;23;7;32;15;0;19;;15;;19;0;38;127;30;47
17.12.2023 10:00;77;112;33;15;38;51;0;40;;24;;62;0;71;189;48;89
17.12.2023 11:00;96;121;42;23;54;49;0;57;;31;;81;0;93;217;65;103
17.12.2023 12:00;126;179;58;25;83;76;0;93;;30;;141;0;124;305;83;159
17.12.2023 13:00;128;224;90;60;115;108;0;154;;42;;189;0;206;352;150;223
17.12.2023 14:00;187;260;86;55;111;98;0;129;;68;;201;0;264;447;141;209
17.12.2023 15:00;209;259;70;32;110;119;0;101;;78;;154;0;269;468;102;229
17.12.2023 16:00;173;252;58;38;77;71;0;78;;49;;124;0;164;425;96;148
17.12.2023 17:00;125;224;18;14;47;36;0;19;;25;;54;0;65;349;32;83
17.12.2023 18:00;88;188;14;5;20;17;0;10;;7;;24;0;40;276;19;37
17.12.2023 19:00;43;138;10;5;14;13;0;8;;9;;18;0;25;181;15;27
17.12.2023 20:00;40;107;4;4;10;15;0;3;;1;;12;0;8;147;8;25
17.12.2023 21:00;40;72;3;5;10;9;0;5;;7;;8;0;9;112;8;19
17.12.2023 22:00;40;63;4;2;8;0;0;0;;5;;2;0;11;103;6;8
17.12.2023 23:00;11;27;2;0;3;3;0;1;;1;;2;0;1;38;2;6
18.12.2023 00:00;4;8;0;0;2;0;0;0;;0;;1;0;0;12;0;2
18.12.2023 01:00;2;13;1;0;3;0;0;0;;0;;0;0;1;15;1;3
18.12.2023 02:00;0;4;0;0;0;0;0;0;;1;;0;0;1;4;0;0
18.12.2023 03:00;2;3;0;1;0;1;0;0;;0;;0;0;0;5;1;1
18.12.2023 04:00;3;5;1;1;5;0;0;0;;0;;0;0;0;8;2;5
18.12.2023 05:00;27;21;7;3;16;8;0;2;;2;;6;0;5;48;10;24
18.12.2023 06:00;93;98;14;29;42;35;0;5;;8;;24;0;29;191;43;77
18.12.2023 07:00;291;269;65;56;141;108;0;56;;37;;124;0;139;560;121;249
18.12.2023 08:00;320;271;46;38;177;171;0;79;;42;;217;0;125;591;84;348
18.12.2023 09:00;192;205;31;10;58;61;0;49;;17;;118;0;54;397;41;119
18.12.2023 10:00;144;182;26;17;50;39;0;42;;18;;57;0;64;326;43;89
18.12.2023 11:00;125;193;26;22;41;41;0;32;;26;;63;0;88;318;48;82
18.12.2023 12:00;133;314;41;22;54;47;0;65;;27;;96;0;90;447;63;101
18.12.2023 13:00;166;354;61;18;52;73;0;52;;37;;119;0;134;520;79;125
18.12.2023 14:00;194;349;48;27;103;77;3;64;;47;;101;0;153;543;75;180
18.12.2023 15:00;211;400;53;26;116;82;0;53;;46;;152;0;163;611;79;198
18.12.2023 16:00;265;490;77;44;144;112;0;63;;69;;167;0;195;755;121;256
18.12.2023 17:00;255;448;51;24;107;91;0;61;;35;;165;0;111;703;75;198
18.12.2023 18:00;192;394;39;10;84;67;0;29;;32;;109;0;74;586;49;151
18.12.2023 19:00;131;285;12;4;30;40;0;22;;8;;53;0;38;416;16;70
18.12.2023 20:00;70;198;14;4;23;14;0;8;;5;;28;0;24;268;18;37
18.12.2023 21:00;67;135;14;3;14;7;0;11;;16;;22;0;23;202;17;21
18.12.2023 22:00;40;119;6;6;11;8;0;4;;3;;10;0;11;159;12;19
18.12.2023 23:00;19;33;2;1;14;5;0;2;;3;;5;0;6;52;3;19
19.12.2023 00:00;7;34;1;1;2;2;0;2;;1;;3;0;0;41;2;4
19.12.2023 01:00;5;8;0;0;0;0;0;0;;0;;0;0;0;13;0;0
19.12.2023 02:00;2;4;1;0;1;0;0;1;;1;;1;0;0;6;1;1
19.12.2023 03:00;3;0;0;1;1;0;0;0;;0;;0;0;0;3;1;1
19.12.2023 04:00;2;7;1;2;2;1;0;0;;0;;0;0;0;9;3;3
19.12.2023 05:00;27;24;7;2;9;3;0;2;;0;;6;0;2;51;9;12
19.12.2023 06:00;85;86;15;34;39;30;0;7;;5;;21;0;31;171;49;69
19.12.2023 07:00;258;270;51;44;114;97;0;60;;23;;120;0;97;528;95;211
19.12.2023 08:00;294;301;62;25;152;130;6;74;;49;;234;0;126;595;87;282
19.12.2023 09:00;193;210;28;9;88;62;2;42;;31;;99;0;73;403;37;150
19.12.2023 10:00;141;183;15;17;38;23;0;25;;19;;68;0;49;324;32;61
19.12.2023 11:00;110;201;18;16;35;29;2;30;;33;;54;0;70;311;34;64
19.12.2023 12:00;150;224;20;8;40;30;2;31;;23;;66;0;83;374;28;70
19.12.2023 13:00;159;278;31;12;57;43;3;43;;25;;80;0;57;437;43;100
19.12.2023 14:00;128;276;35;19;50;51;0;30;;15;;69;0;42;404;54;101
19.12.2023 15:00;113;257;22;3;64;50;0;25;;23;;60;0;50;370;25;114
19.12.2023 16:00;134;266;40;16;75;63;0;41;;25;;113;0;64;400;56;138
19.12.2023 17:00;108;280;27;16;87;55;0;20;;24;;98;0;45;388;43;142
19.12.2023 18:00;105;266;29;8;64;37;0;21;;19;;79;2;47;371;37;101
19.12.2023 19:00;88;190;14;2;31;18;1;7;;7;;25;1;29;278;16;49
19.12.2023 20:00;47;134;6;3;27;5;0;6;;4;;16;0;21;181;9;32
19.12.2023 21:00;39;82;6;1;3;13;0;3;;7;;9;0;11;121;7;16
19.12.2023 22:00;30;58;0;1;7;2;0;1;;4;;4;0;7;88;1;9
19.12.2023 23:00;14;34;1;0;6;4;0;2;;3;;6;0;2;48;1;10
20.12.2023 00:00;11;13;0;0;1;0;0;0;;1;;2;0;0;24;0;1
20.12.2023 01:00;2;6;0;0;0;2;0;0;;0;;1;0;0;8;0;2
20.12.2023 02:00;1;1;2;0;0;0;0;0;;1;;0;0;0;2;2;0
20.12.2023 03:00;2;3;2;1;1;0;0;0;;0;;0;0;0;5;3;1
20.12.2023 04:00;4;3;0;0;2;0;0;0;;0;;1;0;1;7;0;2
20.12.2023 05:00;18;25;4;1;10;5;0;2;;1;;6;0;5;43;5;15
20.12.2023 06:00;72;74;16;18;35;25;0;8;;5;;19;1;27;146;34;60
20.12.2023 07:00;230;249;45;39;103;92;0;43;;25;;110;10;77;479;84;195
20.12.2023 08:00;285;249;49;30;129;118;2;65;;27;;197;12;103;534;79;247
20.12.2023 09:00;174;183;22;7;69;64;2;57;;16;;102;8;62;357;29;133
20.12.2023 10:00;128;203;28;12;39;42;1;37;;16;;63;15;51;331;40;81
20.12.2023 11:00;124;219;29;14;39;37;3;31;;24;;80;8;66;343;43;76
20.12.2023 12:00;124;266;25;9;45;35;4;39;;16;;68;11;48;390;34;80
20.12.2023 13:00;146;278;31;13;44;42;1;40;;27;;86;15;55;424;44;86
20.12.2023 14:00;144;270;35;15;48;63;10;43;;16;;98;16;52;414;50;111
20.12.2023 15:00;147;301;26;12;38;68;3;31;;19;;95;12;56;448;38;106
20.12.2023 16:00;194;331;51;18;97;67;0;56;;34;;110;26;83;525;69;164
20.12.2023 17:00;180;389;39;23;77;68;0;40;;33;;112;11;79;569;62;145
20.12.2023 18:00;154;321;26;12;72;53;0;28;;24;;109;11;70;475;38;125
20.12.2023 19:00;103;283;18;3;24;21;1;15;;14;;47;4;47;386;21;45
20.12.2023 20:00;74;188;11;3;19;14;2;9;;13;;26;4;26;262;14;33
20.12.2023 21:00;53;155;9;3;17;8;0;1;;3;;22;0;19;208;12;25
20.12.2023 22:00;45;128;5;4;7;10;0;4;;6;;19;1;8;173;9;17
20.12.2023 23:00;27;75;3;1;6;3;0;2;;1;;6;0;13;102;4;9
21.12.2023 00:00;9;33;1;3;7;3;0;1;;1;;6;0;2;42;4;10
21.12.2023 01:00;7;23;1;0;2;3;1;0;;0;;0;1;1;30;1;5
21.12.2023 02:00;2;6;0;0;0;0;0;0;;2;;2;0;3;8;0;0
21.12.2023 03:00;1;2;0;0;0;0;0;0;;0;;0;0;0;3;0;0
21.12.2023 04:00;4;4;0;2;2;0;1;1;;0;;2;0;0;8;2;2
21.12.2023 05:00;15;17;3;2;5;6;0;2;;1;;3;0;1;32;5;11
21.12.2023 06:00;45;53;10;22;21;18;1;5;;3;;15;2;16;98;32;39
21.12.2023 07:00;136;132;25;17;65;53;0;20;;7;;58;13;35;268;42;118
21.12.2023 08:00;187;187;26;18;58;67;3;39;;18;;91;7;49;374;44;125
21.12.2023 09:00;139;154;24;11;34;35;5;33;;28;;78;11;52;293;35;69
21.12.2023 10:00;78;113;7;4;14;14;1;9;;15;;31;14;31;191;11;28
21.12.2023 11:00;72;139;6;4;18;13;1;5;;16;;24;8;18;211;10;31
21.12.2023 12:00;71;148;8;9;18;18;1;18;;10;;26;8;28;219;17;36
21.12.2023 13:00;74;177;13;9;26;21;1;9;;11;;36;8;22;251;22;47
21.12.2023 14:00;113;183;12;11;27;29;1;13;;13;;46;12;20;296;23;56
21.12.2023 15:00;106;251;24;13;41;37;4;14;;28;;64;7;29;357;37;78
21.12.2023 16:00;118;247;30;16;46;49;2;27;;20;;73;7;28;365;46;95
21.12.2023 17:00;126;269;27;10;52;32;1;17;;12;;54;9;43;395;37;84
21.12.2023 18:00;80;192;16;4;32;25;0;19;;8;;45;10;20;272;20;57
21.12.2023 19:00;76;135;4;1;18;10;0;4;;3;;25;4;12;211;5;28
21.12.2023 20:00;36;89;3;1;10;2;0;7;;2;;18;2;5;125;4;12
21.12.2023 21:00;26;56;2;1;7;5;0;3;;1;;5;0;5;82;3;12
21.12.2023 22:00;23;40;3;1;3;3;0;0;;3;;3;0;5;63;4;6
21.12.2023 23:00;7;26;3;1;5;1;0;1;;0;;1;0;0;33;4;6
22.12.2023 00:00;6;21;0;0;0;1;0;1;;0;;3;0;3;27;0;1
22.12.2023 01:00;0;9;1;0;2;1;0;0;;0;;0;0;0;9;1;3
22.12.2023 02:00;6;3;1;0;1;0;0;0;;1;;0;0;0;9;1;1
22.12.2023 03:00;0;0;1;1;0;0;0;0;;0;;1;0;0;0;2;0
22.12.2023 04:00;3;3;0;0;3;1;1;0;;0;;0;0;0;6;0;4
22.12.2023 05:00;10;13;3;2;3;2;0;1;;0;;2;0;0;23;5;5
22.12.2023 06:00;35;49;1;12;21;14;3;3;;3;;9;1;5;84;13;35
22.12.2023 07:00;69;95;17;7;32;24;1;11;;8;;35;3;18;164;24;56
22.12.2023 08:00;103;102;10;9;37;20;1;20;;12;;34;3;24;205;19;57
22.12.2023 09:00;76;99;5;12;22;16;3;14;;20;;30;2;13;175;17;38
22.12.2023 10:00;101;129;11;6;13;17;1;9;;20;;29;0;29;230;17;30
22.12.2023 11:00;85;169;10;10;21;14;2;20;;17;;35;5;27;254;20;35
22.12.2023 12:00;90;164;15;12;17;21;0;13;;19;;41;5;35;254;27;38
22.12.2023 13:00;92;191;13;9;27;19;2;17;;9;;38;2;32;283;22;46
22.12.2023 14:00;85;175;11;12;23;17;0;18;;19;;40;5;25;260;23;40
22.12.2023 15:00;78;215;13;6;30;13;0;20;;7;;33;4;29;293;19;43
22.12.2023 16:00;85;186;11;1;36;36;0;15;;16;;36;4;32;271;12;72
22.12.2023 17:00;88;189;12;5;24;15;0;15;;9;;29;3;23;277;17;39
22.12.2023 18:00;90;171;20;4;18;13;0;8;;9;;20;2;26;261;24;31
22.12.2023 19:00;52;149;6;4;12;17;0;10;;7;;11;0;11;201;10;29
22.12.2023 20:00;47;99;4;0;12;3;0;1;;6;;5;0;15;146;4;15
22.12.2023 21:00;38;72;8;1;4;6;0;1;;2;;7;0;5;110;9;10
22.12.2023 22:00;22;32;5;2;7;4;0;2;;2;;0;0;2;54;7;11
22.12.2023 23:00;11;20;3;0;5;0;0;1;;0;;1;0;1;31;3;5
23.12.2023 00:00;7;25;1;0;5;3;0;0;;0;;4;0;2;32;1;8
23.12.2023 01:00;11;29;1;3;4;3;0;0;;1;;0;0;2;40;4;7
23.12.2023 02:00;4;18;0;1;1;3;0;0;;1;;0;0;2;22;1;4
23.12.2023 03:00;5;7;0;0;1;0;0;0;;1;;0;0;0;12;0;1
23.12.2023 04:00;2;1;0;1;5;1;0;3;;0;;2;0;0;3;1;6
23.12.2023 05:00;2;7;1;0;1;2;0;0;;0;;0;0;0;9;1;3
23.12.2023 06:00;6;6;0;1;1;1;0;0;;0;;1;0;1;12;1;2
23.12.2023 07:00;5;13;1;0;8;3;0;2;;2;;4;0;2;18;1;11
23.12.2023 08:00;30;30;9;7;1;1;0;7;;5;;9;0;5;60;16;2
23.12.2023 09:00;38;61;5;5;10;6;0;6;;9;;10;0;24;99;10;16
23.12.2023 10:00;76;108;13;4;18;13;0;16;;20;;27;0;31;184;17;31
23.12.2023 11:00;100;151;18;14;24;15;0;19;;26;;39;0;54;251;32;39
23.12.2023 12:00;87;193;20;11;20;30;0;29;;21;;52;0;47;280;31;50
23.12.2023 13:00;101;196;20;7;19;23;0;28;;21;;51;0;58;297;27;42
23.12.2023 14:00;78;160;14;11;27;19;0;43;;13;;38;0;52;238;25;46
23.12.2023 15:00;67;191;20;6;23;23;0;26;;23;;49;0;53;258;26;46
23.12.2023 16:00;66;183;13;10;36;16;0;24;;9;;30;0;44;249;23;52
23.12.2023 17:00;91;178;12;4;10;7;0;8;;16;;22;0;33;269;16;17
23.12.2023 18:00;62;116;5;4;11;10;0;11;;7;;22;0;17;178;9;21
23.12.2023 19:00;61;88;4;4;8;9;0;5;;7;;8;0;22;149;8;17
23.12.2023 20:00;42;89;3;1;6;6;0;4;;6;;12;0;12;131;4;12
23.12.2023 21:00;22;47;3;1;1;4;0;2;;6;;5;0;7;69;4;5
23.12.2023 22:00;14;42;4;0;3;4;0;1;;1;;7;0;3;56;4;7
23.12.2023 23:00;17;42;3;1;6;3;0;0;;1;;1;0;12;59;4;9
24.12.2023 00:00;14;27;1;2;0;3;0;1;;4;;2;0;1;41;3;3
24.12.2023 01:00;4;25;3;0;1;1;0;0;;1;;0;0;7;29;3;2
24.12.2023 02:00;3;16;1;0;0;0;0;0;;0;;1;0;1;19;1;0
24.12.2023 03:00;1;9;1;0;0;0;0;0;;0;;0;0;0;10;1;0
24.12.2023 04:00;2;9;0;0;0;0;0;0;;0;;0;0;0;11;0;0
24.12.2023 05:00;5;3;1;0;1;2;0;0;;0;;0;0;1;8;1;3
24.12.2023 06:00;11;2;1;0;5;0;0;1;;0;;1;0;2;13;1;5
24.12.2023 07:00;6;12;6;2;5;4;0;1;;1;;4;0;4;18;8;9
24.12.2023 08:00;7;13;3;3;7;6;0;6;;3;;9;0;18;20;6;13
24.12.2023 09:00;14;28;11;8;12;13;0;12;;12;;24;0;35;42;19;25
24.12.2023 10:00;50;40;25;10;23;23;0;24;;20;;47;0;47;90;35;46
24.12.2023 11:00;41;65;36;14;18;39;0;42;;15;;62;0;44;106;50;57
24.12.2023 12:00;45;67;29;17;34;28;0;49;;15;;67;0;53;112;46;62
24.12.2023 13:00;56;56;14;13;22;30;0;35;;15;;56;0;71;112;27;52
24.12.2023 14:00;22;27;5;5;20;11;0;12;;7;;17;0;17;49;10;31
24.12.2023 15:00;20;34;7;4;14;6;0;12;;6;;13;0;14;54;11;20
24.12.2023 16:00;24;29;12;11;18;18;0;18;;8;;25;0;15;53;23;36
24.12.2023 17:00;24;46;5;3;12;10;0;13;;4;;21;0;12;70;8;22
24.12.2023 18:00;9;19;2;2;8;5;0;3;;8;;3;0;13;28;4;13
24.12.2023 19:00;9;15;1;0;1;2;0;3;;2;;2;0;1;24;1;3
24.12.2023 20:00;7;11;0;1;0;1;0;8;;0;;0;0;1;18;1;1
24.12.2023 21:00;11;11;3;3;3;3;0;1;;2;;1;0;4;22;6;6
24.12.2023 22:00;14;13;1;0;4;0;0;0;;1;;0;0;5;27;1;4
24.12.2023 23:00;13;22;2;1;5;2;0;0;;2;;0;0;5;35;3;7
25.12.2023 00:00;9;16;2;1;0;3;0;1;;1;;2;0;7;25;3;3
25.12.2023 01:00;6;13;2;0;1;0;0;0;;1;;4;0;5;19;2;1
25.12.2023 02:00;1;14;0;0;0;2;0;2;;0;;0;0;0;15;0;2
25.12.2023 03:00;4;7;0;1;1;0;0;0;;0;;0;0;0;11;1;1
25.12.2023 04:00;5;4;0;0;0;0;0;1;;0;;0;0;2;9;0;0
25.12.2023 05:00;4;4;1;1;0;5;0;0;;0;;0;0;1;8;2;5
25.12.2023 06:00;9;3;0;0;1;1;0;1;;1;;0;0;5;12;0;2
25.12.2023 07:00;5;4;2;2;5;5;0;1;;0;;0;0;4;9;4;10
25.12.2023 08:00;6;9;2;0;2;5;0;1;;0;;0;0;6;15;2;7
25.12.2023 09:00;9;21;4;1;5;1;0;1;;1;;0;0;12;30;5;6
25.12.2023 10:00;18;15;8;8;4;9;0;4;;6;;0;0;26;33;16;13
25.12.2023 11:00;37;49;19;3;21;27;0;3;;17;;2;0;62;86;22;48
25.12.2023 12:00;30;74;29;18;24;28;0;12;;25;;0;0;54;104;47;52
25.12.2023 13:00;43;74;41;17;39;27;0;1;;18;;0;0;62;117;58;66
25.12.2023 14:00;35;60;36;17;32;25;0;1;;29;;0;0;43;95;53;57
25.12.2023 15:00;42;39;15;13;18;20;0;0;;19;;0;0;27;81;28;38
25.12.2023 16:00;28;69;8;11;12;16;0;0;;17;;0;0;31;97;19;28
25.12.2023 17:00;35;41;8;5;12;11;0;0;;7;;0;0;19;76;13;23
25.12.2023 18:00;35;25;6;0;10;10;0;0;;5;;0;0;12;60;6;20
25.12.2023 19:00;19;33;5;1;8;5;0;1;;4;;0;0;13;52;6;13
25.12.2023 20:00;21;24;5;0;5;2;0;0;;3;;0;0;6;45;5;7
25.12.2023 21:00;19;30;1;3;5;2;0;0;;2;;0;0;5;49;4;7
25.12.2023 22:00;22;14;2;2;8;4;0;0;;1;;0;0;8;36;4;12
25.12.2023 23:00;13;14;4;0;4;4;0;0;;5;;0;0;15;27;4;8
26.12.2023 00:00;6;14;0;0;1;2;0;0;;0;;0;0;4;20;0;3
26.12.2023 01:00;3;4;2;2;2;1;0;0;;3;;0;0;2;7;4;3
26.12.2023 02:00;3;3;0;0;1;0;0;0;;0;;0;0;0;6;0;1
26.12.2023 03:00;4;1;0;0;1;0;0;0;;0;;0;0;0;5;0;1
26.12.2023 04:00;4;5;0;0;0;0;0;0;;0;;0;0;0;9;0;0
26.12.2023 05:00;2;4;0;0;0;2;0;0;;0;;0;0;0;6;0;2
26.12.2023 06:00;4;4;1;2;2;5;0;0;;1;;0;0;3;8;3;7
26.12.2023 07:00;5;14;2;3;3;6;0;0;;0;;0;0;2;19;5;9
26.12.2023 08:00;9;12;4;3;6;2;0;0;;2;;0;0;7;21;7;8
26.12.2023 09:00;34;24;13;7;20;16;0;0;;7;;0;0;37;58;20;36
26.12.2023 10:00;39;56;24;16;24;27;0;0;;30;;0;0;58;95;40;51
26.12.2023 11:00;68;87;47;38;41;36;0;0;;32;;0;0;80;155;85;77
26.12.2023 12:00;87;133;66;27;64;48;0;0;;34;;0;0;99;220;93;112
26.12.2023 13:00;86;120;58;35;95;68;0;0;;49;;0;0;77;206;93;163
26.12.2023 14:00;87;157;56;45;87;58;0;0;;49;;0;0;98;244;101;145
26.12.2023 15:00;84;122;51;30;58;69;0;0;;44;;0;0;85;206;81;127
26.12.2023 16:00;67;104;26;25;46;38;0;0;;39;;0;0;64;171;51;84
26.12.2023 17:00;58;112;14;8;17;19;0;0;;21;;0;0;24;170;22;36
26.12.2023 18:00;56;52;7;4;7;4;0;0;;8;;0;0;13;108;11;11
26.12.2023 19:00;35;50;16;2;12;9;0;0;;8;;0;0;7;85;18;21
26.12.2023 20:00;39;53;9;0;9;12;0;0;;10;;0;0;10;92;9;21
26.12.2023 21:00;30;44;2;1;6;1;0;0;;8;;0;0;5;74;3;7
26.12.2023 22:00;25;23;4;2;4;5;0;0;;2;;0;0;5;48;6;9
26.12.2023 23:00;10;24;1;3;8;1;0;0;;2;;0;0;2;34;4;9
27.12.2023 00:00;9;16;0;0;1;2;0;0;;3;;0;0;4;25;0;3
27.12.2023 01:00;7;10;3;0;1;1;0;0;;1;;0;0;5;17;3;2
27.12.2023 02:00;0;8;0;0;0;0;0;0;;2;;0;0;0;8;0;0
27.12.2023 03:00;5;4;0;0;0;0;0;0;;0;;0;0;0;9;0;0
27.12.2023 04:00;3;9;1;0;2;1;0;0;;0;;0;0;1;12;1;3
27.12.2023 05:00;15;15;4;1;8;5;0;0;;0;;0;0;1;30;5;13
27.12.2023 06:00;32;36;7;8;15;11;0;0;;3;;0;0;9;68;15;26
27.12.2023 07:00;65;74;18;8;36;24;0;0;;6;;0;0;14;139;26;60
27.12.2023 08:00;62;69;10;5;41;20;0;0;;12;;0;0;21;131;15;61
27.12.2023 09:00;70;75;17;5;34;26;0;1;;12;;0;0;36;145;22;60
27.12.2023 10:00;94;128;18;20;26;31;0;2;;15;;0;0;47;222;38;57
27.12.2023 11:00;105;157;34;18;23;33;0;1;;30;;0;0;96;262;52;56
27.12.2023 12:00;103;149;26;15;27;30;0;2;;32;;0;0;104;252;41;57
27.12.2023 13:00;121;184;37;15;53;38;0;3;;21;;0;0;85;305;52;91
27.12.2023 14:00;128;202;29;25;40;51;0;7;;44;;0;0;95;330;54;91
27.12.2023 15:00;128;226;36;29;67;50;0;20;;46;;0;0;97;354;65;117
27.12.2023 16:00;126;259;30;19;61;52;0;21;;35;;0;0;124;385;49;113
27.12.2023 17:00;111;243;28;13;39;27;0;8;;37;;0;0;49;354;41;66
27.12.2023 18:00;62;163;10;10;21;22;0;1;;15;;1;0;21;225;20;43
27.12.2023 19:00;67;151;7;3;14;8;0;1;;7;;0;0;20;218;10;22
27.12.2023 20:00;63;62;1;1;9;9;0;1;;5;;0;0;18;125;2;18
27.12.2023 21:00;26;56;1;1;3;4;0;1;;4;;1;0;9;82;2;7
27.12.2023 22:00;20;46;2;2;5;9;0;3;;3;;0;0;3;66;4;14
27.12.2023 23:00;12;32;2;0;6;8;0;0;;0;;1;0;3;44;2;14
28.12.2023 00:00;14;23;2;2;2;2;0;1;;2;;1;0;1;37;4;4
28.12.2023 01:00;7;9;1;1;0;1;0;0;;1;;3;0;3;16;2;1
28.12.2023 02:00;4;11;1;0;0;0;0;0;;4;;3;0;2;15;1;0
28.12.2023 03:00;4;2;0;0;0;0;0;0;;1;;0;0;2;6;0;0
28.12.2023 04:00;1;3;0;0;3;0;0;0;;1;;1;0;2;4;0;3
28.12.2023 05:00;21;12;3;2;7;5;0;0;;2;;3;0;5;33;5;12
28.12.2023 06:00;40;39;10;8;19;14;0;0;;5;;8;0;7;79;18;33
28.12.2023 07:00;75;91;25;14;31;31;0;3;;7;;15;0;22;166;39;62
28.12.2023 08:00;86;72;19;9;39;36;0;11;;14;;24;0;43;158;28;75
28.12.2023 09:00;64;114;24;18;42;22;0;15;;9;;31;0;41;178;42;64
28.12.2023 10:00;113;139;39;22;44;43;0;43;;36;;56;0;80;252;61;87
28.12.2023 11:00;121;205;40;19;53;71;0;42;;47;;107;0;117;326;59;124
28.12.2023 12:00;164;241;70;25;69;63;0;68;;55;;121;0;161;405;95;132
28.12.2023 13:00;193;306;53;34;93;71;0;90;;54;;132;0;200;499;87;164
28.12.2023 14:00;178;301;80;45;105;70;0;114;;54;;140;0;238;479;125;175
28.12.2023 15:00;202;308;59;26;89;115;0;65;;69;;138;0;200;510;85;204
28.12.2023 16:00;154;301;48;26;97;75;0;68;;42;;105;0;118;455;74;172
28.12.2023 17:00;113;266;19;12;52;52;0;24;;18;;67;0;68;379;31;104
28.12.2023 18:00;98;168;13;11;27;28;0;14;;22;;28;0;34;266;24;55
28.12.2023 19:00;103;147;9;4;15;15;0;6;;10;;19;0;20;250;13;30
28.12.2023 20:00;67;99;5;3;13;4;0;7;;8;;11;0;11;166;8;17
28.12.2023 21:00;36;68;5;1;12;8;0;5;;2;;10;0;9;104;6;20
28.12.2023 22:00;21;47;3;6;8;3;0;2;;1;;4;0;15;68;9;11
28.12.2023 23:00;22;50;7;4;8;0;0;2;;2;;4;0;6;72;11;8
29.12.2023 00:00;8;34;1;2;2;2;0;1;;0;;3;0;1;42;3;4
29.12.2023 01:00;8;27;2;0;1;2;0;0;;0;;0;0;1;35;2;3
29.12.2023 02:00;10;9;2;0;3;1;0;0;;2;;0;0;2;19;2;4
29.12.2023 03:00;2;6;1;0;0;0;0;0;;0;;0;0;0;8;1;0
29.12.2023 04:00;0;13;1;0;4;2;0;0;;1;;1;0;0;13;1;6
29.12.2023 05:00;11;8;8;2;3;2;0;0;;1;;4;0;1;19;10;5
29.12.2023 06:00;32;28;5;7;10;8;0;0;;3;;1;0;4;60;12;18
29.12.2023 07:00;50;73;20;9;29;20;0;4;;4;;21;0;23;123;29;49
29.12.2023 08:00;60;64;14;7;37;20;0;10;;10;;21;0;21;124;21;57
29.12.2023 09:00;64;95;12;5;22;20;0;15;;11;;33;0;27;159;17;42
29.12.2023 10:00;93;128;16;9;21;28;0;23;;15;;34;0;44;221;25;49
29.12.2023 11:00;132;157;15;11;29;36;0;33;;25;;67;0;70;289;26;65
29.12.2023 12:00;127;171;22;13;40;37;0;41;;24;;81;0;91;298;35;77
29.12.2023 13:00;112;181;34;18;51;39;0;53;;36;;65;0;84;293;52;90
29.12.2023 14:00;121;257;30;15;40;33;3;46;;21;;71;0;71;378;45;73
29.12.2023 15:00;107;225;28;8;41;27;0;54;;29;;70;0;66;332;36;68
29.12.2023 16:00;100;179;18;13;37;33;0;32;;26;;57;0;59;279;31;70
29.12.2023 17:00;89;202;16;15;24;18;0;16;;25;;37;0;38;291;31;42
29.12.2023 18:00;85;161;18;5;21;13;0;13;;13;;27;0;32;246;23;34
29.12.2023 19:00;73;148;6;5;23;8;0;3;;10;;19;0;15;221;11;31
29.12.2023 20:00;52;80;4;2;10;7;0;10;;5;;14;0;16;132;6;17
29.12.2023 21:00;38;59;2;4;15;4;0;2;;3;;9;0;8;97;6;19
29.12.2023 22:00;34;73;5;2;2;1;0;3;;4;;6;0;7;107;7;3
29.12.2023 23:00;15;35;2;0;13;5;0;4;;2;;5;0;1;50;2;18
30.12.2023 00:00;14;29;2;0;7;4;0;1;;2;;7;0;3;43;2;11
30.12.2023 01:00;8;18;3;3;1;2;0;1;;0;;0;0;3;26;6;3
30.12.2023 02:00;5;17;1;0;2;0;0;0;;1;;1;0;1;22;1;2
30.12.2023 03:00;3;12;0;0;0;1;0;0;;0;;0;0;0;15;0;1
30.12.2023 04:00;1;11;0;0;1;1;0;1;;0;;1;0;0;12;0;2
30.12.2023 05:00;5;9;1;1;3;1;0;2;;0;;0;0;0;14;2;4
30.12.2023 06:00;4;12;3;6;3;0;2;1;;1;;0;0;2;16;9;3
30.12.2023 07:00;13;18;7;4;1;10;2;1;;1;;5;0;11;31;11;11
30.12.2023 08:00;30;34;5;8;9;6;3;7;;6;;14;0;7;64;13;15
30.12.2023 09:00;66;78;16;8;25;13;3;11;;6;;19;1;35;144;24;38
30.12.2023 10:00;85;126;39;18;29;37;4;33;;54;;49;5;60;211;57;66
30.12.2023 11:00;145;178;30;29;65;40;6;69;;48;;79;6;125;323;59;105
30.12.2023 12:00;158;195;58;38;63;53;10;90;;45;;109;11;153;353;96;116
30.12.2023 13:00;174;265;70;38;63;62;34;88;;64;;180;35;188;439;108;125
30.12.2023 14:00;179;292;82;43;95;90;10;89;;53;;185;30;244;471;125;185
30.12.2023 15:00;177;284;61;38;90;100;19;112;;68;;160;28;227;461;99;190
30.12.2023 16:00;116;215;62;24;60;70;1;106;;29;;128;16;142;331;86;130
30.12.2023 17:00;104;171;31;13;24;21;2;30;;22;;59;5;70;275;44;45
30.12.2023 18:00;77;180;11;14;17;17;0;13;;15;;28;1;28;257;25;34
30.12.2023 19:00;81;101;10;10;17;7;0;9;;20;;21;0;20;182;20;24
30.12.2023 20:00;33;73;4;8;8;10;0;2;;5;;22;0;18;106;12;18
30.12.2023 21:00;39;50;9;1;12;5;0;5;;2;;8;0;9;89;10;17
30.12.2023 22:00;22;41;5;6;0;3;0;1;;1;;8;5;13;63;11;3
30.12.2023 23:00;15;22;2;0;5;6;0;2;;2;;5;0;0;37;2;11
31.12.2023 00:00;13;24;4;1;5;2;0;0;;5;;4;1;0;37;5;7
31.12.2023 01:00;3;12;1;1;1;1;0;0;;4;;1;0;5;15;2;2
31.12.2023 02:00;3;11;1;1;0;0;0;2;;0;;0;0;0;14;2;0
31.12.2023 03:00;3;2;2;0;0;2;0;0;;0;;2;0;0;5;2;2
31.12.2023 04:00;0;5;0;0;0;0;0;1;;0;;1;0;0;5;0;0
31.12.2023 05:00;5;6;1;1;2;1;0;0;;0;;1;0;2;11;2;3
31.12.2023 06:00;2;4;3;3;1;1;0;2;;1;;2;1;2;6;6;2
31.12.2023 07:00;3;6;4;3;3;9;0;4;;0;;7;0;3;9;7;12
31.12.2023 08:00;9;21;7;3;8;7;0;14;;3;;17;3;10;30;10;15
31.12.2023 09:00;39;57;8;9;29;24;5;27;;5;;44;6;30;96;17;53
31.12.2023 10:00;65;104;19;10;22;27;8;38;;19;;27;10;70;169;29;49
31.12.2023 11:00;50;99;23;19;29;32;4;36;;31;;20;19;55;149;42;61
31.12.2023 12:00;77;127;40;11;26;39;12;70;;25;;68;13;73;204;51;65
31.12.2023 13:00;78;102;40;11;58;40;16;63;;28;;99;19;77;180;51;98
31.12.2023 14:00;73;113;44;24;50;46;22;71;;38;;104;33;102;186;68;96
31.12.2023 15:00;94;136;63;33;56;77;18;75;;49;;119;29;180;230;96;133
31.12.2023 16:00;100;122;48;16;42;58;9;70;;41;;80;22;111;222;64;100
31.12.2023 17:00;75;89;19;6;31;27;7;33;;18;;42;13;46;164;25;58
31.12.2023 18:00;61;95;10;5;21;10;0;9;;10;;23;1;26;156;15;31
31.12.2023 19:00;48;98;9;3;9;13;0;5;;7;;11;2;18;146;12;22
31.12.2023 20:00;41;58;7;8;6;4;0;2;;5;;13;0;10;99;15;10
31.12.2023 21:00;28;41;5;0;2;7;0;6;;3;;13;0;12;69;5;9
31.12.2023 22:00;12;34;0;0;10;3;0;1;;4;;11;0;5;46;0;13
31.12.2023 23:00;16;34;8;3;4;5;0;8;;9;;24;0;10;50;11;9
